【汉字篇】
夢|ゆめ|梦想、梦境|夢はとても大切です。|使用「夢」的例句：梦想、梦境很重要
蓮|はす|莲花|蓮を買いました。|使用「蓮」的例句：买了莲花
柄|がら|花纹、性格|これは柄です。|使用「柄」的例句：这是花纹、性格
虹|にじ|彩虹|虹を買いました。|使用「虹」的例句：买了彩虹
嘘|うそ|谎言|嘘が好きです。|使用「嘘」的例句：喜欢谎言
毒|どく|毒、恶意|毒について話します。|使用「毒」的例句：谈论毒、恶意
傷|きず|伤口、瑕疵|傷を買いました。|使用「傷」的例句：买了伤口、瑕疵
跡|あと|痕迹、遗迹|跡について話します。|使用「跡」的例句：谈论痕迹、遗迹
損|そん|损失、不利|損を持っています。|使用「損」的例句：有损失、不利
鬱|うつ|抑郁、忧郁|鬱を買いました。|使用「鬱」的例句：买了抑郁、忧郁
楽|らく|轻松、快乐|楽気持ちです。|使用「楽」的例句：轻松、快乐的心情
役|やく|角色、作用|役が好きです。|使用「役」的例句：喜欢角色、作用
姿|すがた|姿态、身形|姿について話します。|使用「姿」的例句：谈论姿态、身形
肩|かた|肩膀|肩について話します。|使用「肩」的例句：谈论肩膀
胸|むね|胸部|胸はとても大切です。|使用「胸」的例句：胸部很重要
腹|はら|腹部|腹はとても大切です。|使用「腹」的例句：腹部很重要
肝|きも|肝脏|肝が好きです。|使用「肝」的例句：喜欢肝脏
腰|こし|腰部|腰が好きです。|使用「腰」的例句：喜欢腰部
膝|ひざ|膝盖|膝を買いました。|使用「膝」的例句：买了膝盖
扉|とびら|门、门径|扉はとても大切です。|使用「扉」的例句：门、门径很重要
麓|ふもと|山脚、山麓|麓はとても大切です。|使用「麓」的例句：山脚、山麓很重要
鍵|かぎ|钥匙、关键|鍵を持っています。|使用「鍵」的例句：有钥匙、关键
釘|くぎ|钉子|新しい釘です。|使用「釘」的例句：新的钉子
針|はり|针、指针|針を買いました。|使用「針」的例句：买了针、指针
方針|ほうしん|方针、政策|方針について話します。|使用「方針」的例句：谈论方针、政策
方法|ほうほう|方法、手段|方法はとても大切です。|使用「方法」的例句：方法、手段很重要
法律|ほうりつ|法律|法律が好きです。|使用「法律」的例句：喜欢法律
規律|きりつ|纪律、规矩|これは規律です。|使用「規律」的例句：这是纪律、规矩
規則|きそく|规则|これは規則です。|使用「規則」的例句：这是规则
規模|きぼ|规模、大小|規模天気ですね。|使用「規模」的例句：规模、大小的天气呢
模本|もほん|模板、样本|模本はとても大切です。|使用「模本」的例句：模板、样本很重要
模範|もはん|模范、榜样|これは模範です。|使用「模範」的例句：这是模范、榜样
模様|もよう|花纹、情况|模様が好きです。|使用「模様」的例句：喜欢花纹、情况
様子|ようす|样子、情况|様子を買いました。|使用「様子」的例句：买了样子、情况
容姿|ようし|容貌、外表|容姿を持っています。|使用「容姿」的例句：有容貌、外表
姿勢|しせい|姿势、态度|姿勢はとても大切です。|使用「姿勢」的例句：姿势、态度很重要
格好|かっこう|外形、打扮|格好天気ですね。|使用「格好」的例句：外形、打扮的天气呢
格安|かくやす|价格便宜|格安を持っています。|使用「格安」的例句：有价格便宜
安易|あんい|轻率、简单|これは安易です。|使用「安易」的例句：这是轻率、简单
依頼|いらい|委托、请求|依頼はとても大切です。|使用「依頼」的例句：委托、请求很重要
信頼|しんらい|信赖、依赖|信頼はとても大切です。|使用「信頼」的例句：信赖、依赖很重要
信仰|しんこう|信仰|信仰はとても大切です。|使用「信仰」的例句：信仰很重要
頑固|がんこ|顽固、固执|頑固について話します。|使用「頑固」的例句：谈论顽固、固执
頑丈|がんじょう|结实|頑丈が好きです。|使用「頑丈」的例句：喜欢结实
評判|ひょうばん|评价|評判はとても大切です。|使用「評判」的例句：评价很重要
批評|ひひょう|批评、评论|批評を買いました。|使用「批評」的例句：买了批评、评论
評価|ひょうか|评价、估价|評価について話します。|使用「評価」的例句：谈论评价、估价
形式|けいしき|形式、方式|形式を買いました。|使用「形式」的例句：买了形式、方式
景色|けしき|景色、风景|これは景色です。|使用「景色」的例句：这是景色、风景
特色|とくしょく|特色|特色を持っています。|使用「特色」的例句：有特色
特徴|とくちょう|特征|特徴を持っています。|使用「特徴」的例句：有特征
独特|どくとく|与众不同|独特を持っています。|使用「独特」的例句：有与众不同
苦情|くじょう|抱怨、投诉|苦情を買いました。|使用「苦情」的例句：买了抱怨、投诉
情報|じょうほう|信息|これは情報です。|使用「情報」的例句：这是信息
報告|ほうこく|报告、汇报|報告について話します。|使用「報告」的例句：谈论报告、汇报
告白|こくはく|告白、表白|告白を買いました。|使用「告白」的例句：买了告白、表白
納得|なっとく|理解、同意|納得について話します。|使用「納得」的例句：谈论理解、同意
納|おさ|缴纳、支付|納はとても大切です。|使用「納」的例句：缴纳、支付很重要
収納|しゅうのう|收纳|収納を買いました。|使用「収納」的例句：买了收纳
収穫|しゅうかく|收获|収穫を買いました。|使用「収穫」的例句：买了收获
吸収|きゅうしゅう|吸收|吸収を持っています。|使用「吸収」的例句：有吸收
領収書|りょうしゅうしょ|收据|領収書が好きです。|使用「領収書」的例句：喜欢收据
普及|ふきゅう|普及|新しい普及です。|使用「普及」的例句：新的普及
至急|しきゅう|紧急、急迫|至急について話します。|使用「至急」的例句：谈论紧急、急迫
地球|ちきゅう|地球、世界|地球はとても大切です。|使用「地球」的例句：地球、世界很重要
導入|どうにゅう|引入|導入を持っています。|使用「導入」的例句：有引入
輸送|ゆそう|运输、运送|輸送はとても大切です。|使用「輸送」的例句：运输、运送很重要
郵送|ゆうそう|邮寄、寄送|郵送が好きです。|使用「郵送」的例句：喜欢邮寄、寄送
寄付|きふ|捐赠、捐款|寄付について話します。|使用「寄付」的例句：谈论捐赠、捐款
付属|ふぞく|附属、附带|新しい付属です。|使用「付属」的例句：新的附属、附带
添付|てんぷ|附加、附上|添付を持っています。|使用「添付」的例句：有附加、附上
提案|ていあん|提案、建议|提案はとても大切です。|使用「提案」的例句：提案、建议很重要
案内|あんない|引导、通知|これは案内です。|使用「案内」的例句：这是引导、通知
参照|さんしょう|参考|新しい参照です。|使用「参照」的例句：新的参考
参考|さんこう|参考|これは参考です。|使用「参考」的例句：这是参考
考慮|こうりょ|考虑、斟酌|考慮を買いました。|使用「考慮」的例句：买了考虑、斟酌
配慮|はいりょ|关怀、关心|配慮が好きです。|使用「配慮」的例句：喜欢关怀、关心
遠慮|えんりょ|顾虑、客气|遠慮はとても大切です。|使用「遠慮」的例句：顾虑、客气很重要
柔軟|じゅうなん|柔软、灵活|柔軟を買いました。|使用「柔軟」的例句：买了柔软、灵活
軟弱|なんじゃく|弱、软弱|これは軟弱です。|使用「軟弱」的例句：这是弱、软弱
曖昧|あいまい|模糊、含糊|新しい曖昧です。|使用「曖昧」的例句：新的模糊、含糊
丁寧|ていねい|礼貌、细心|丁寧はとても大切です。|使用「丁寧」的例句：礼貌、细心很重要
挨拶|あいさつ|打招呼|挨拶を持っています。|使用「挨拶」的例句：有打招呼
抵抗|ていこう|抵抗、抵触|抵抗を持っています。|使用「抵抗」的例句：有抵抗、抵触
逃亡|とうぼう|逃亡、逃跑|逃亡について話します。|使用「逃亡」的例句：谈论逃亡、逃跑
逃避|とうひ|逃避、逃脱|逃避が好きです。|使用「逃避」的例句：喜欢逃避、逃脱
避難|ひなん|避难|避難はとても大切です。|使用「避難」的例句：避难很重要
契機|けいき|契机、机会|契機を買いました。|使用「契機」的例句：买了契机、机会
優先|ゆうせん|优先、先行|これは優先です。|使用「優先」的例句：这是优先、先行
乾燥|かんそう|干燥、枯燥|乾燥が好きです。|使用「乾燥」的例句：喜欢干燥、枯燥
礼儀|れいぎ|礼仪、礼节|礼儀を買いました。|使用「礼儀」的例句：买了礼仪、礼节
掲載|けいさい|刊登、发表|掲載について話します。|使用「掲載」的例句：谈论刊登、发表
深刻|しんこく|深刻、严重|これは深刻です。|使用「深刻」的例句：这是深刻、严重
運賃|うんちん|运费、车费|これは運賃です。|使用「運賃」的例句：这是运费、车费
撮影|さつえい|摄影、拍摄|新しい撮影です。|使用「撮影」的例句：新的摄影、拍摄
角度|かくど|角度、视角|角度を買いました。|使用「角度」的例句：买了角度、视角
象徴|しょうちょう|象征|象徴を買いました。|使用「象徴」的例句：买了象征
範囲|はんい|范围|範囲を買いました。|使用「範囲」的例句：买了范围
豊富|ほうふ|丰富、充实|これは豊富です。|使用「豊富」的例句：这是丰富、充实
削除|さくじょ|删除、去除|明日削除つもりです。|使用「削除」的例句：明天打算删除、去除
夢中|むちゅう|沉迷、专心|夢中はとても大切です。|使用「夢中」的例句：沉迷、专心很重要
奇妙|きみょう|奇妙、奇怪|奇妙について話します。|使用「奇妙」的例句：谈论奇妙、奇怪
矛盾|むじゅん|矛盾、冲突|矛盾を買いました。|使用「矛盾」的例句：买了矛盾、冲突
返却|へんきゃく|返还|返却について話します。|使用「返却」的例句：谈论返还
組織|そしき|组织、机构|新しい組織です。|使用「組織」的例句：新的组织、机构
冷静|れいせい|冷静、镇静|冷静人です。|使用「冷静」的例句：冷静、镇静的人
歓迎|かんげい|欢迎、接待|歓迎について話します。|使用「歓迎」的例句：谈论欢迎、接待
勧誘|かんゆう|劝诱、邀请|勧誘はとても大切です。|使用「勧誘」的例句：劝诱、邀请很重要
立派|りっぱ|壮丽、出色|立派はとても大切です。|使用「立派」的例句：壮丽、出色很重要
印刷|いんさつ|印刷、打印|印刷はとても大切です。|使用「印刷」的例句：印刷、打印很重要
即座|そくざ|立刻|即座が好きです。|使用「即座」的例句：喜欢立刻
中継|ちゅうけい|转换|これは中継です。|使用「中継」的例句：这是转换
贅沢|ぜいたく|奢侈、奢华|贅沢を買いました。|使用「贅沢」的例句：买了奢侈、奢华
幼稚|ようち|幼稚、稚嫩|幼稚を買いました。|使用「幼稚」的例句：买了幼稚、稚嫩
批判|ひはん|批评、批判|批判を買いました。|使用「批判」的例句：买了批评、批判
体格|たいかく|体格|体格はとても大切です。|使用「体格」的例句：体格很重要
異常|いじょう|异常|異常はとても大切です。|使用「異常」的例句：异常很重要
極端|きょくたん|极端、极度|極端が好きです。|使用「極端」的例句：喜欢极端、极度
貿易|ぼうえき|贸易、交易|貿易を買いました。|使用「貿易」的例句：买了贸易、交易
我慢|がまん|忍耐、耐性|我慢人です。|使用「我慢」的例句：忍耐、耐性的人
支持|しじ|支持、拥护|支持はとても大切です。|使用「支持」的例句：支持、拥护很重要
許可|きょか|许可、批准|許可を買いました。|使用「許可」的例句：买了许可、批准
距離|きょり|距离、间隔|これは距離です。|使用「距離」的例句：这是距离、间隔
円満|えんまん|圆满、和谐|円満が好きです。|使用「円満」的例句：喜欢圆满、和谐
恐怖|きょうふ|恐怖、害怕|新しい恐怖です。|使用「恐怖」的例句：新的恐怖、害怕
拒否|きょひ|拒绝、否决|拒否を買いました。|使用「拒否」的例句：买了拒绝、否决
幻想|げんそう|幻想、梦幻|幻想が好きです。|使用「幻想」的例句：喜欢幻想、梦幻
栽培|さいばい|种植、栽培|これは栽培です。|使用「栽培」的例句：这是种植、栽培
治療|ちりょう|治疗|治療を買いました。|使用「治療」的例句：买了治疗
採集|さいしゅう|收集、采集|採集が好きです。|使用「採集」的例句：喜欢收集、采集
取得|しゅとく|取得、获得|新しい取得です。|使用「取得」的例句：新的取得、获得
起源|きげん|起源、源头|起源を買いました。|使用「起源」的例句：买了起源、源头
願望|がんぼう|愿望、渴望|願望を買いました。|使用「願望」的例句：买了愿望、渴望
製造|せいぞう|制造、生产|製造はとても大切です。|使用「製造」的例句：制造、生产很重要
提供|ていきょう|提供、供应|提供を買いました。|使用「提供」的例句：买了提供、供应
邪魔|じゃま|妨碍、打扰|邪魔が好きです。|使用「邪魔」的例句：喜欢妨碍、打扰
濃厚|のうこう|浓厚、浓烈|これは濃厚です。|使用「濃厚」的例句：这是浓厚、浓烈
高級|こうきゅう|高级、豪华|高級気持ちです。|使用「高級」的例句：高级、豪华的心情
優秀|ゆうしゅう|优秀、出色|優秀を買いました。|使用「優秀」的例句：买了优秀、出色
鮮明|せんめい|鲜明、清晰|鮮明について話します。|使用「鮮明」的例句：谈论鲜明、清晰
過剰|かじょう|过度、过量|過剰はとても大切です。|使用「過剰」的例句：过度、过量很重要
臆病|おくびょう|胆小、害怕|臆病天気ですね。|使用「臆病」的例句：胆小、害怕的天气呢
緩和|かんわ|缓和、缓解|緩和について話します。|使用「緩和」的例句：谈论缓和、缓解
両替|りょうがえ|兑换、换钱|両替が好きです。|使用「両替」的例句：喜欢兑换、换钱
強化|きょうか|强化、增强|強化はとても大切です。|使用「強化」的例句：强化、增强很重要
在籍|ざいせき|在职、在籍|在籍を持っています。|使用「在籍」的例句：有在职、在籍
福祉|ふくし|福利、福祉|福祉について話します。|使用「福祉」的例句：谈论福利、福祉
冗談|じょうだん|玩笑、讽刺|冗談はとても大切です。|使用「冗談」的例句：玩笑、讽刺很重要
自慢|じまん|自豪、骄傲|とても自慢です。|使用「自慢」的例句：非常自豪、骄傲
抽選|ちゅうせん|抽奖、抽签|抽選が好きです。|使用「抽選」的例句：喜欢抽奖、抽签
警備|けいび|警备、保安|警備が好きです。|使用「警備」的例句：喜欢警备、保安
習慣|しゅうかん|习惯、惯例|習慣について話します。|使用「習慣」的例句：谈论习惯、惯例
次元|じげん|维度、次元|新しい次元です。|使用「次元」的例句：新的维度、次元
地元|じもと|本地、家乡|新しい地元です。|使用「地元」的例句：新的本地、家乡
土台|どだい|基础、根基|新しい土台です。|使用「土台」的例句：新的基础、根基
立場|たちば|立场、立足点|立場を持っています。|使用「立場」的例句：有立场、立足点
急激|きゅうげき|急剧、迅猛|急激を買いました。|使用「急激」的例句：买了急剧、迅猛
技術|ぎじゅつ|技术、工艺|技術が好きです。|使用「技術」的例句：喜欢技术、工艺
工夫|くふう|设计、努力|工夫が好きです。|使用「工夫」的例句：喜欢设计、努力
訓練|くんれん|训练、培养|新しい訓練です。|使用「訓練」的例句：新的训练、培养
多彩|たさい|多彩、丰富|多彩が好きです。|使用「多彩」的例句：喜欢多彩、丰富
刺激|しげき|刺激、激励|これは刺激です。|使用「刺激」的例句：这是刺激、激励
指摘|してき|指出|指摘を買いました。|使用「指摘」的例句：买了指出
鈍感|どんかん|钝感、迟钝|鈍感はとても大切です。|使用「鈍感」的例句：钝感、迟钝很重要
失望|しつぼう|失望、沮丧|失望が好きです。|使用「失望」的例句：喜欢失望、沮丧
覚悟|かくご|准备、觉悟|新しい覚悟です。|使用「覚悟」的例句：新的准备、觉悟
区別|くべつ|区分、区别|これは区別です。|使用「区別」的例句：这是区分、区别
心配|しんぱい|担心、忧虑|母のことが心配です|担心母亲
化粧|けしょう|化妆、装饰|化粧について話します。|使用「化粧」的例句：谈论化妆、装饰
負担|ふたん|负担、负荷|負担について話します。|使用「負担」的例句：谈论负担、负荷
余計|よけい|多余、愈发|余計はとても大切です。|使用「余計」的例句：多余、愈发很重要
本物|ほんもの|真正、真品|これは本物です。|使用「本物」的例句：这是真正、真品
欠陥|けっかん|缺陷、瑕疵|欠陥はとても大切です。|使用「欠陥」的例句：缺陷、瑕疵很重要
視野|しや|视野、眼界|視野はとても大切です。|使用「視野」的例句：视野、眼界很重要
視線|しせん|视线、目光|新しい視線です。|使用「視線」的例句：新的视线、目光
視察|しさつ|视察、考察|視察を買いました。|使用「視察」的例句：买了视察、考察
視点|してん|视角、视点|新しい視点です。|使用「視点」的例句：新的视角、视点
欠点|けってん|缺点、短处|とても欠点です。|使用「欠点」的例句：非常缺点、短处
弱点|じゃくてん|弱点、短板|弱点気持ちです。|使用「弱点」的例句：弱点、短板的心情
点検|てんけん|检查、点检|これは点検です。|使用「点検」的例句：这是检查、点检
得点|とくてん|得分、分数|得点が好きです。|使用「得点」的例句：喜欢得分、分数
焦点|しょうてん|焦点、重点|焦点が好きです。|使用「焦点」的例句：喜欢焦点、重点
終点|しゅうてん|终点|終点を持っています。|使用「終点」的例句：有终点
重点|じゅうてん|重点、要点|重点はとても大切です。|使用「重点」的例句：重点、要点很重要
貴重|きちょう|贵重、珍贵|貴重が好きです。|使用「貴重」的例句：喜欢贵重、珍贵
尊重|そんちょう|尊重、尊敬|新しい尊重です。|使用「尊重」的例句：新的尊重、尊敬
油断|ゆだん|疏忽、大意|油断人です。|使用「油断」的例句：疏忽、大意的人
利点|りてん|优点、好处|利点気持ちです。|使用「利点」的例句：优点、好处的心情
権利|けんり|权利、权益|新しい権利です。|使用「権利」的例句：新的权利、权益
勝利|しょうり|胜利、成功|勝利が好きです。|使用「勝利」的例句：喜欢胜利、成功
有利|ゆうり|有利、优越|有利を買いました。|使用「有利」的例句：买了有利、优越
無口|むくち|沉默、不善言辞|無口を買いました。|使用「無口」的例句：买了沉默、不善言辞
無事|ぶじ|安全、无事|無事について話します。|使用「無事」的例句：谈论安全、无事
行事|ぎょうじ|活动、事件|一緒に行事ましょう。|使用「行事」的例句：一起活动、事件吧
流行|りゅうこう|流行、时尚|流行が好きです。|使用「流行」的例句：喜欢流行、时尚
行方|ゆくえ|去向、下落|行方ことができます。|使用「行方」的例句：能够去向、下落
移行|いこう|过渡、转移|移行はとても大切です。|使用「移行」的例句：过渡、转移很重要
移動|いどう|移动、搬迁|時々移動ます。|使用「移動」的例句：有时移动、搬迁
動作|どうさ|动作、行为|毎日動作ます。|使用「動作」的例句：每天动作、行为
感動|かんどう|感动、激动|毎日感動ます。|使用「感動」的例句：每天感动、激动
活動|かつどう|活动、行动|今日は活動ました。|使用「活動」的例句：今天活动、行动了
活躍|かつやく|出色表现|活躍を持っています。|使用「活躍」的例句：有出色表现
復活|ふっかつ|复活、复兴|復活について話します。|使用「復活」的例句：谈论复活、复兴
回復|かいふく|恢复|回復を買いました。|使用「回復」的例句：买了恢复
回答|かいとう|回答、答复|回答を持っています。|使用「回答」的例句：有回答、答复
応答|おうとう|回应、回答|応答を買いました。|使用「応答」的例句：买了回应、回答
対応|たいおう|对应、处理|対応を持っています。|使用「対応」的例句：有对应、处理
絶対|ぜったい|绝对、无条件|これは絶対です。|使用「絶対」的例句：这是绝对、无条件
対策|たいさく|对策、措施|対策を買いました。|使用「対策」的例句：买了对策、措施
対比|たいひ|对比、对照|対比が好きです。|使用「対比」的例句：喜欢对比、对照
比較|ひかく|比较、对比|これは比較です。|使用「比較」的例句：这是比较、对比
比例|ひれい|比例、批判|比例を持っています。|使用「比例」的例句：有比例、批判
例外|れいがい|例外、异常|例外について話します。|使用「例外」的例句：谈论例外、异常
外側|そとがわ|外面、外侧|外側を買いました。|使用「外側」的例句：买了外面、外侧
外見|がいけん|外貌、外观|これは外見です。|使用「外見」的例句：这是外貌、外观
見当|けんとう|估计、方向|これは見当です。|使用「見当」的例句：这是估计、方向
見解|けんかい|见解、看法|今日は見解ました。|使用「見解」的例句：今天见解、看法了
解消|かいしょう|解除、消除|解消はとても大切です。|使用「解消」的例句：解除、消除很重要
解約|かいやく|解约、取消|解約はとても大切です。|使用「解約」的例句：解约、取消很重要
了解|りょうかい|了解、明白|了解を買いました。|使用「了解」的例句：买了了解、明白
分解|ぶんかい|分解、解析|分解を持っています。|使用「分解」的例句：有分解、解析
分別|ぶんべつ|分类、分辨|分別が好きです。|使用「分別」的例句：喜欢分类、分辨
分担|ぶんたん|分担、承担|分担が好きです。|使用「分担」的例句：喜欢分担、承担
分配|ぶんぱい|分配|分配が好きです。|使用「分配」的例句：喜欢分配
分野|ぶんや|领域、范围|分野について話します。|使用「分野」的例句：谈论领域、范围
分析|ぶんせき|分析、剖析|分析を持っています。|使用「分析」的例句：有分析、剖析
区分|くぶん|区分、分类|区分が好きです。|使用「区分」的例句：喜欢区分、分类
気分|きぶん|心情、情绪|気分について話します。|使用「気分」的例句：谈论心情、情绪
病気|びょうき|疾病、病症|病気について話します。|使用「病気」的例句：谈论疾病、病症
短気|たんき|急躁、暴躁|これは短気です。|使用「短気」的例句：这是急躁、暴躁
元気|げんき|耐心、毅力|元気が好きです。|使用「元気」的例句：喜欢耐心、毅力
根気|こんき|精力、健康|根気が好きです。|使用「根気」的例句：喜欢精力、健康
気配|けはい|迹象、行情|気配を買いました。|使用「気配」的例句：买了迹象、行情
活気|かっき|活力|活気はとても大切です。|使用「活気」的例句：活力很重要
活発|かっぱつ|活跃、积极|活発を買いました。|使用「活発」的例句：买了活跃、积极
出発|しゅっぱつ|出发、启程|出発を買いました。|使用「出発」的例句：买了出发、启程
始発|しはつ|始发、始发车|始発が好きです。|使用「始発」的例句：喜欢始发、始发车
発生|はっせい|发生、产生|発生を買いました。|使用「発生」的例句：买了发生、产生
発明|はつめい|发明、创造|新しい発明です。|使用「発明」的例句：新的发明、创造
発言|はつげん|讲话、发言|発言はとても大切です。|使用「発言」的例句：讲话、发言很重要
発達|はったつ|发展、发达|発達について話します。|使用「発達」的例句：谈论发展、发达
発想|はっそう|构思、想法|新しい発想です。|使用「発想」的例句：新的构思、想法
発展|はってん|发展、扩展|発展について話します。|使用「発展」的例句：谈论发展、扩展
発揮|はっき|发挥、展现|発揮を買いました。|使用「発揮」的例句：买了发挥、展现
開発|かいはつ|开发|開発について話します。|使用「開発」的例句：谈论开发
展開|てんかい|展开、发展|展開について話します。|使用「展開」的例句：谈论展开、发展
開幕|かいまく|开幕、揭幕|開幕を持っています。|使用「開幕」的例句：有开幕、揭幕
開催|かいさい|举办、举行|開催について話します。|使用「開催」的例句：谈论举办、举行
催促|さいそく|催促|催促が好きです。|使用「催促」的例句：喜欢催促
促進|そくしん|促进、推动|促進ことができます。|使用「促進」的例句：能够促进、推动
進路|しんろ|进路、前进方向|進路が好きです。|使用「進路」的例句：喜欢进路、前进方向
進行|しんこう|进行、进展|進行を持っています。|使用「進行」的例句：有进行、进展
進学|しんがく|升学|進学を買いました。|使用「進学」的例句：买了升学
退学|たいがく|退学、辍学|退学はとても大切です。|使用「退学」的例句：退学、辍学很重要
引退|いんたい|引退、退役|引退を持っています。|使用「引退」的例句：有引退、退役
退屈|たいくつ|无聊、烦闷|退屈について話します。|使用「退屈」的例句：谈论无聊、烦闷
辞退|じたい|辞退、拒绝|辞退について話します。|使用「辞退」的例句：谈论辞退、拒绝
撤退|てったい|撤退、退却|撤退を持っています。|使用「撤退」的例句：有撤退、退却
退職|たいしょく|退休、辞职|これは退職です。|使用「退職」的例句：这是退休、辞职
転職|てんしょく|换工作、改行|一緒に転職ましょう。|使用「転職」的例句：一起换工作、改行吧
転勤|てんきん|工作调动|時々転勤ます。|使用「転勤」的例句：有时工作调动
転換|てんかん|转变、改变|転換を買いました。|使用「転換」的例句：买了转变、改变
交換|こうかん|交换、调换|交換について話します。|使用「交換」的例句：谈论交换、调换
交代|こうたい|交替、替换|交代について話します。|使用「交代」的例句：谈论交替、替换
有効|ゆうこう|有效、有效力|有効を持っています。|使用「有効」的例句：有有效、有效力
効果|こうか|效果、影响|効果が好きです。|使用「効果」的例句：喜欢效果、影响
効用|こうよう|效用、用途|効用を持っています。|使用「効用」的例句：有效用、用途
用途|ようと|用途|新しい用途です。|使用「用途」的例句：新的用途
共用|きょうよう|共用、共享|共用はとても大切です。|使用「共用」的例句：共用、共享很重要
引用|いんよう|引用|引用を買いました。|使用「引用」的例句：买了引用
採用|さいよう|采用、录用|採用はとても大切です。|使用「採用」的例句：采用、录用很重要
専用|せんよう|专用、专门|専用はとても大切です。|使用「専用」的例句：专用、专门很重要
専属|せんぞく|专属、专门|専属を買いました。|使用「専属」的例句：买了专属、专门
専心|せんしん|专心、专注|専心を買いました。|使用「専心」的例句：买了专心、专注
残念|ざんねん|遗憾、可惜|新しい残念です。|使用「残念」的例句：新的遗憾、可惜
念頭|ねんとう|念头、心中|念頭を買いました。|使用「念頭」的例句：买了念头、心中
頭上|ずじょう|头顶、上面|頭上について話します。|使用「頭上」的例句：谈论头顶、上面
目上|めうえ|上司、长辈|目上気持ちです。|使用「目上」的例句：上司、长辈的心情
役目|やくめ|任务、职责|役目を持っています。|使用「役目」的例句：有任务、职责
目印|めじるし|标记|目印はとても大切です。|使用「目印」的例句：标记很重要
注目|ちゅうもく|注目、关注|注目を買いました。|使用「注目」的例句：买了注目、关注
注文|ちゅうもん|订单、点单|これは注文です。|使用「注文」的例句：这是订单、点单
文句|もんく|抱怨、意见|文句を買いました。|使用「文句」的例句：买了抱怨、意见
愚痴|ぐち|抱怨、发牢骚|愚痴を持っています。|使用「愚痴」的例句：有抱怨、发牢骚
目安|めやす|基准、大概的|目安気持ちです。|使用「目安」的例句：基准、大概的的心情
目標|もくひょう|目标、目的|目標気持ちです。|使用「目標」的例句：目标、目的的心情
標識|ひょうしき|标志|標識を持っています。|使用「標識」的例句：有标志
知識|ちしき|知识、学问|これは知識です。|使用「知識」的例句：这是知识、学问
承知|しょうち|了解、同意|承知を買いました。|使用「承知」的例句：买了了解、同意
措置|そち|措施、手段|措置を持っています。|使用「措置」的例句：有措施、手段
処置|しょち|处理、处置|処置を持っています。|使用「処置」的例句：有处理、处置
処理|しょり|处理、处置|処理について話します。|使用「処理」的例句：谈论处理、处置
修理|しゅうり|修理、修复|これは修理です。|使用「修理」的例句：这是修理、修复
無理|むり|不可能、过分|新しい無理です。|使用「無理」的例句：新的不可能、过分
理論|りろん|理论|理論が好きです。|使用「理論」的例句：喜欢理论
論争|ろんそう|争论、辩论|論争が好きです。|使用「論争」的例句：喜欢争论、辩论
討論|とうろん|讨论、辩论|これは討論です。|使用「討論」的例句：这是讨论、辩论
検討|けんとう|检讨、考虑|検討を買いました。|使用「検討」的例句：买了检讨、考虑
検査|けんさ|检查、审查|検査が好きです。|使用「検査」的例句：喜欢检查、审查
調査|ちょうさ|调查、研究|調査について話します。|使用「調査」的例句：谈论调查、研究
順調|じゅんちょう|顺利|順調を買いました。|使用「順調」的例句：买了顺利
調和|ちょうわ|良好、顺|調和ところです。|使用「調和」的例句：良好、顺的地方
調整|ちょうせい|调整、调节|調整について話します。|使用「調整」的例句：谈论调整、调节
整備|せいび|整备、维护|新しい整備です。|使用「整備」的例句：新的整备、维护
調節|ちょうせつ|调节、管控|調節を買いました。|使用「調節」的例句：买了调节、管控
節約|せつやく|节约、节省|これは節約です。|使用「節約」的例句：这是节约、节省
予約|よやく|预定、预约|予約について話します。|使用「予約」的例句：谈论预定、预约
予報|よほう|预报、预测|予報が好きです。|使用「予報」的例句：喜欢预报、预测
予感|よかん|预感、预兆|新しい予感です。|使用「予感」的例句：新的预感、预兆
予習|よしゅう|预习、预备|これは予習です。|使用「予習」的例句：这是预习、预备
予測|よそく|预测、预估|予測について話します。|使用「予測」的例句：谈论预测、预估
観測|かんそく|观察、监测|観測を買いました。|使用「観測」的例句：买了观察、监测
測定|そくてい|测定、测量|測定について話します。|使用「測定」的例句：谈论测定、测量
定着|ていちゃく|定论、固|定着はとても大切です。|使用「定着」的例句：定论、固很重要
仮定|かてい|假定、假设|仮定はとても大切です。|使用「仮定」的例句：假定、假设很重要
限定|げんてい|限定、限制|限定について話します。|使用「限定」的例句：谈论限定、限制
制限|せいげん|限制、约束|これは制限です。|使用「制限」的例句：这是限制、约束
限界|げんかい|界限、极限|限界について話します。|使用「限界」的例句：谈论界限、极限
指定|してい|指定|指定を買いました。|使用「指定」的例句：买了指定
設定|せってい|设置，设定|設定を持っています。|使用「設定」的例句：有设置，设定
決定|けってい|决定、决策|新しい決定です。|使用「決定」的例句：新的决定、决策
勘定|かんじょう|账单、计算|勘定が好きです。|使用「勘定」的例句：喜欢账单、计算
確認|かくにん|确认、核实|新しい確認です。|使用「確認」的例句：新的确认、核实
確保|かくほ|确保、保证|確保が好きです。|使用「確保」的例句：喜欢确保、保证
保証|ほしょう|保证、担保|これは保証です。|使用「保証」的例句：这是保证、担保
保存|ほぞん|保存、保管|保存が好きです。|使用「保存」的例句：喜欢保存、保管
保護|ほご|保护、防护|新しい保護です。|使用「保護」的例句：新的保护、防护
看護|かんご|看护、护理|よく看護ます。|使用「看護」的例句：经常看护、护理
介護|かいご|介护、照顾|新しい介護です。|使用「介護」的例句：新的介护、照顾
紹介|しょうかい|介绍、推荐|紹介を持っています。|使用「紹介」的例句：有介绍、推荐
招待|しょうたい|招待|招待はとても大切です。|使用「招待」的例句：招待很重要
期待|きたい|期待、盼望|期待を買いました。|使用「期待」的例句：买了期待、盼望
延期|えんき|延期、推迟|延期を買いました。|使用「延期」的例句：买了延期、推迟
待遇|たいぐう|等候的人|待遇天気ですね。|使用「待遇」的例句：等候的人的天气呢
人格|じんかく|人品、性格|新しい人格です。|使用「人格」的例句：新的人品、性格
求人|きゅうじん|招聘|求人が好きです。|使用「求人」的例句：喜欢招聘
追求|ついきゅう|追求，追寻|追求を買いました。|使用「追求」的例句：买了追求，追寻
追加|ついか|追加、补充|追加はとても大切です。|使用「追加」的例句：追加、补充很重要
増加|ぞうか|增加，增长|増加天気ですね。|使用「増加」的例句：增加，增长的天气呢
増大|ぞうだい|增大、扩展|増大天気ですね。|使用「増大」的例句：增大、扩展的天气呢
大幅|おおはば|大幅、大量|とても大幅です。|使用「大幅」的例句：非常大幅、大量
大声|おおごえ|大声、喊声|大声気持ちです。|使用「大声」的例句：大声、喊声的心情
大変|たいへん|严重、非常|大変を買いました。|使用「大変」的例句：买了严重、非常
変更|へんこう|变更、修改|変更を買いました。|使用「変更」的例句：买了变更、修改
変換|へんかん|转换、变换|変換はとても大切です。|使用「変換」的例句：转换、变换很重要
改造|かいぞう|改造、重建|改造について話します。|使用「改造」的例句：谈论改造、重建
改善|かいぜん|改善、改进|改善はとても大切です。|使用「改善」的例句：改善、改进很重要
改革|かいかく|改革|改革について話します。|使用「改革」的例句：谈论改革
改訂|かいてい|修订、改订|これは改訂です。|使用「改訂」的例句：这是修订、改订
訂正|ていせい|更正、订正|新しい訂正です。|使用「訂正」的例句：新的更正、订正
正式|せいしき|正式、正式的|正式気持ちです。|使用「正式」的例句：正式、正式的的心情
補正|ほせい|补正、修正|これは補正です。|使用「補正」的例句：这是补正、修正
補足|ほそく|补充、补足|これは補足です。|使用「補足」的例句：这是补充、补足
候補|こうほ|候选、候补|候補はとても大切です。|使用「候補」的例句：候选、候补很重要
補助|ほじょ|补助、援助|補助を持っています。|使用「補助」的例句：有补助、援助
補充|ほじゅう|补充、填补|補充について話します。|使用「補充」的例句：谈论补充、填补
拡充|かくじゅう|扩充、扩大|拡充ところです。|使用「拡充」的例句：扩充、扩大的地方
充実|じゅうじつ|充实、完善|充実を持っています。|使用「充実」的例句：有充实、完善
実現|じつげん|实现、真真|実現について話します。|使用「実現」的例句：谈论实现、真真
実施|じっし|实施、执行|実施について話します。|使用「実施」的例句：谈论实施、执行
実践|じっせん|实践|実践はとても大切です。|使用「実践」的例句：实践很重要
実感|じっかん|实感、真实感|実感を買いました。|使用「実感」的例句：买了实感、真实感
事実|じじつ|事实、实际|これは事実です。|使用「事実」的例句：这是事实、实际
実際|じっさい|实际、实际上|実際を買いました。|使用「実際」的例句：买了实际、实际上
間際|まぎわ|临近、快要|間際気持ちです。|使用「間際」的例句：临近、快要的心情
仲間|なかま|伙伴、同伴|これは仲間です。|使用「仲間」的例句：这是伙伴、同伴
昼間|ひるま|白天、日间|昼間が好きです。|使用「昼間」的例句：喜欢白天、日间
夜間|やかん|夜间、夜晚|夜間について話します。|使用「夜間」的例句：谈论夜间、夜晚
間隔|かんかく|间隔、距离|間隔が好きです。|使用「間隔」的例句：喜欢间隔、距离
世間|せけん|社会、世间|世間が好きです。|使用「世間」的例句：喜欢社会、世间
出世|しゅっせ|出人头地|出世が好きです。|使用「出世」的例句：喜欢出人头地
輩出|はいしゅつ|输出、培养|輩出はとても大切です。|使用「輩出」的例句：输出、培养很重要
進出|しんしゅつ|进军、扩展|進出はとても大切です。|使用「進出」的例句：进军、扩展很重要
続出|ぞくしゅつ|接连发生或出现|続出はとても大切です。|使用「続出」的例句：接连发生或出现很重要
持続|じぞく|持续、维持|これは持続です。|使用「持続」的例句：这是持续、维持
継続|けいぞく|继续、持续|継続を持っています。|使用「継続」的例句：有继续、持续
接続|せつぞく|连接、接合|接続を持っています。|使用「接続」的例句：有连接、接合
直接|ちょくせつ|直接、亲自|直接が好きです。|使用「直接」的例句：喜欢直接、亲自
直接|ちょくせつ|紧接着、立即|新しい直接です。|使用「直接」的例句：新的紧接着、立即
後日|ごじつ|后来、日后|毎日後日ます。|使用「後日」的例句：每天后来、日后
終日|しゅうじつ|一整天|終日を買いました。|使用「終日」的例句：买了一整天
平日|へいじつ|工作日、平日|今日は平日ました。|使用「平日」的例句：今天工作日、平日了
休日|きゅうじつ|休息日|休日が好きです。|使用「休日」的例句：喜欢休息日
日課|にっか|每日的任务|日課気持ちです。|使用「日課」的例句：每日的任务的心情
当日|とうじつ|当天,那天|当日が好きです。|使用「当日」的例句：喜欢当天,那天
当然|とうぜん|理所当然|新しい当然です。|使用「当然」的例句：新的理所当然
相当|そうとう|相当、相匹配|相当はとても大切です。|使用「相当」的例句：相当、相匹配很重要
相互|そうご|互相、相互|相互について話します。|使用「相互」的例句：谈论互相、相互
相談|そうだん|商量、咨询|相談を買いました。|使用「相談」的例句：买了商量、咨询
相違|そうい|差异、不同|相違を持っています。|使用「相違」的例句：有差异、不同
違反|いはん|违反、违背|違反を買いました。|使用「違反」的例句：买了违反、违背
反抗|はんこう|反抗、抵抗|反抗について話します。|使用「反抗」的例句：谈论反抗、抵抗
反映|はんえい|反映、映射|新しい反映です。|使用「反映」的例句：新的反映、映射
反省|はんせい|反省、反思|反省を持っています。|使用「反省」的例句：有反省、反思
省略|しょうりゃく|省略|省略を持っています。|使用「省略」的例句：有省略
簡略|かんりゃく|简略、简化|簡略が好きです。|使用「簡略」的例句：喜欢简略、简化
簡潔|かんけつ|简洁、简明|簡潔について話します。|使用「簡潔」的例句：谈论简洁、简明
簡単|かんたん|简单、容易|簡単について話します。|使用「簡単」的例句：谈论简单、容易
単純|たんじゅん|单纯、简单|単純が好きです。|使用「単純」的例句：喜欢单纯、简单
一番|いちばん|最、第一|一番を買いました。|使用「一番」的例句：买了最、第一
一斉|いっせい|一齐、同时|一斉が好きです。|使用「一斉」的例句：喜欢一齐、同时
一緒|いっしょ|一起、共同|これは一緒です。|使用「一緒」的例句：这是一起、共同
精一杯|せいいっぱい|尽全力|精一杯が好きです。|使用「精一杯」的例句：喜欢尽全力
一生懸命|いっしょうけんめい|拼命、尽全力|これは一生懸命です。|使用「一生懸命」的例句：这是拼命、尽全力
唯一|ゆいいつ|唯一|唯一が好きです。|使用「唯一」的例句：喜欢唯一
統一|とういつ|统一、一致|新しい統一です。|使用「統一」的例句：新的统一、一致
伝統|でんとう|传统、惯例|伝統を持っています。|使用「伝統」的例句：有传统、惯例
宣伝|せんでん|宣传、广告|これは宣伝です。|使用「宣伝」的例句：这是宣传、广告
伝達|でんたつ|传达、传播|これは伝達です。|使用「伝達」的例句：这是传达、传播
達成|たっせい|达成、完成|達成が好きです。|使用「達成」的例句：喜欢达成、完成
上達|じょうたつ|进步、提高|上達気持ちです。|使用「上達」的例句：进步、提高的心情
上位|じょうい|上位、地位等极高|上位ところです。|使用「上位」的例句：上位、地位等极高的地方
上昇|じょうしょう|上升|上昇が好きです。|使用「上昇」的例句：喜欢上升
屋上|おくじょう|屋顶、楼顶|屋上を買いました。|使用「屋上」的例句：买了屋顶、楼顶
向上|こうじょう|向上、提高|とても向上です。|使用「向上」的例句：非常向上、提高
上旬|じょうじゅん|上旬|上旬を持っています。|使用「上旬」的例句：有上旬
下旬|げじゅん|下旬、月末|新しい下旬です。|使用「下旬」的例句：新的下旬、月末
下手|じょうず|擅长、熟练|下手天気ですね。|使用「下手」的例句：擅长、熟练的天气呢
下手|へた|不擅长、不熟练|下手天気ですね。|使用「下手」的例句：不擅长、不熟练的天气呢
下痢|げり|腹泻|新しい下痢です。|使用「下痢」的例句：新的腹泻
手入れ|ていれ|修理、保养|手入れはとても大切です。|使用「手入れ」的例句：修理、保养很重要
手当て|てあて|津贴、治疗|新しい手当てです。|使用「手当て」的例句：新的津贴、治疗
手間|てま|工夫（时间、精力等）|新しい手間です。|使用「手間」的例句：新的工夫（时间、精力等）
適度|てきど|适度、适中|適度を持っています。|使用「適度」的例句：有适度、适中
適切|てきせつ|适当、恰当|適切が好きです。|使用「適切」的例句：喜欢适当、恰当
適応|てきおう|适应、顺应|適応を持っています。|使用「適応」的例句：有适应、顺应
応援|おうえん|支援、鼓励|これは応援です。|使用「応援」的例句：这是支援、鼓励
援助|えんじょ|援助、帮助|これは援助です。|使用「援助」的例句：这是援助、帮助
助言|じょげん|劝告、建议|助言を買いました。|使用「助言」的例句：买了劝告、建议
言語|げんご|语言、语种|言語について話します。|使用「言語」的例句：谈论语言、语种
語彙|ごい|词汇|新しい語彙です。|使用「語彙」的例句：新的词汇
語源|ごげん|词源、词根|語源が好きです。|使用「語源」的例句：喜欢词源、词根
原爆|げんばく|核爆|原爆を買いました。|使用「原爆」的例句：买了核爆
原材料|げんざいりょう|原料|原材料を持っています。|使用「原材料」的例句：有原料
取材|しゅざい|采访、取材|取材を持っています。|使用「取材」的例句：有采访、取材
素材|そざい|材料、原料|素材が好きです。|使用「素材」的例句：喜欢材料、原料
素人|しろうと|外行|素人が好きです。|使用「素人」的例句：喜欢外行
素顔|すがお|本来面貌、素颜|時々素顔ます。|使用「素顔」的例句：有时本来面貌、素颜
素足|すあし|赤脚、光脚|これは素足です。|使用「素足」的例句：这是赤脚、光脚
充足|あしもと|脚下、步伐|充足を買いました。|使用「充足」的例句：买了脚下、步伐
不足|ふそく|不足、不够|不足について話します。|使用「不足」的例句：谈论不足、不够
積極|せっきょく|积极、主动|一緒に積極ましょう。|使用「積極」的例句：一起积极、主动吧
消極|しょうきょく|消极、被动|時々消極ます。|使用「消極」的例句：有时消极、被动
意図|いと|意图，打算|これは意図です。|使用「意図」的例句：这是意图，打算
得意|とくい|擅长、得意|得意人です。|使用「得意」的例句：擅长、得意的人
悪意|あくい|恶意、敌意|悪意が好きです。|使用「悪意」的例句：喜欢恶意、敌意
意外|いがい|意外、出乎意料|意外を買いました。|使用「意外」的例句：买了意外、出乎意料
意欲|いよく|意欲、动机|意欲ことができます。|使用「意欲」的例句：能够意欲、动机
合意|ごうい|合意、同意|合意が好きです。|使用「合意」的例句：喜欢合意、同意
合併|がっぺい|合并、兼并|合併を持っています。|使用「合併」的例句：有合并、兼并
合図|あいず|信号、暗号|合図を持っています。|使用「合図」的例句：有信号、暗号
具合|ぐあい|状况、情况|具合を持っています。|使用「具合」的例句：有状况、情况
都合|つごう|方便、情况|新しい都合です。|使用「都合」的例句：新的方便、情况
都会|とかい|都市、都会|都会はとても大切です。|使用「都会」的例句：都市、都会很重要
機会|きかい|机会、时机|機会を持っています。|使用「機会」的例句：有机会、时机
機嫌|きげん|心情、情绪|機嫌が好きです。|使用「機嫌」的例句：喜欢心情、情绪
会見|かいけん|会见、采访|これは会見です。|使用「会見」的例句：这是会见、采访
雑談|ざつだん|闲聊、杂谈|新しい雑談です。|使用「雑談」的例句：新的闲聊、杂谈
混雑|こんざつ|拥挤、混乱|混雑はとても大切です。|使用「混雑」的例句：拥挤、混乱很重要
混乱|こんらん|混乱、紊乱|混乱が好きです。|使用「混乱」的例句：喜欢混乱、紊乱
乱暴|らんぼう|粗暴、野蛮|乱暴な言葉遣い|粗鲁的言语
防災|ぼうさい|防灾|防災について話します。|使用「防災」的例句：谈论防灾
災害|さいがい|灾害、灾难|災害について話します。|使用「災害」的例句：谈论灾害、灾难
被害|ひがい|受害、损失|今回の台風上陸の被害は全国各地に及んだ。|这次台风登陆的灾害波及全国各地。
損害|そんがい|損害、损失|損害はとても大切です。|使用「損害」的例句：損害、损失很重要
障害|しょうがい|障碍|障害について話します。|使用「障害」的例句：谈论障碍
現象|げんしょう|現象、情況|現象はとても大切です。|使用「現象」的例句：現象、情況很重要
現状|げんじょう|当前状况|現状を持っています。|使用「現状」的例句：有当前状况
状態|じょうたい|状态、情况|これは状態です。|使用「状態」的例句：这是状态、情况
表現|ひょうげん|表现、表达|これは表現です。|使用「表現」的例句：这是表现、表达
表面|ひょうめん|表面、外表|新しい表面です。|使用「表面」的例句：新的表面、外表
画面|がめん|屏幕、画面|画面について話します。|使用「画面」的例句：谈论屏幕、画面
企画|きかく|企划、计划|企画について話します。|使用「企画」的例句：谈论企划、计划
計画|けいかく|计划、规划|計画について話します。|使用「計画」的例句：谈论计划、规划
面倒|めんどう|麻烦、繁琐|面倒について話します。|使用「面倒」的例句：谈论麻烦、繁琐
面接|めんせつ|面试、会面|これは面接です。|使用「面接」的例句：这是面试、会面
密接|みっせつ|密切、紧密|これは密接です。|使用「密接」的例句：这是密切、紧密
秘密|ひみつ|秘密、机密|これは秘密です。|使用「秘密」的例句：这是秘密、机密
必死|ひっし|拼命、死命|必死を持っています。|使用「必死」的例句：有拼命、死命
必要|ひつよう|必要、必需|新しい必要です。|使用「必要」的例句：新的必要、必需
要求|ようきゅう|要求、需求|要求を持っています。|使用「要求」的例句：有要求、需求
欲求|よっきゅう|欲望、需求|これは欲求です。|使用「欲求」的例句：这是欲望、需求
拡張|かくちょう|扩展、扩张|拡張について話します。|使用「拡張」的例句：谈论扩展、扩张
緊張|きんちょう|紧张、焦虑|緊張を買いました。|使用「緊張」的例句：买了紧张、焦虑
緊迫|きんぱく|紧迫、迫切|緊迫はとても大切です。|使用「緊迫」的例句：紧迫、迫切很重要

【动词篇】
競う|きそう|竞争、比赛|競うが好きです。|使用「競う」的例句：喜欢竞争、比赛
狙う|ねらう|瞄准、伺机|優勝を狙う|以夺取冠军为目标
従う|したがう|遵从、跟随|命令に従う|服从命令
伺う|うかがう|拜访、请教|先生のご意見を伺う|请教老师的意见
構う|かまう|在意、照顾|時間に構わず電話する|不顧时间打电话
報う|むくう|回报、报答|苦労が報われる|辛苦有了回报
敵う|かなう|敌得过、与…匹敌|君には敵わないよ|比不过你
扱う|あつかう|操作、使用；处置、处理；对待，对付；经营|扱うが好きです。|使用「扱う」的例句：喜欢操作、使用；处置、处理；对待，对付；经营
狂う|くるう|失常；打乱；发疯、疯狂|彼は嫉妬で狂いそうだった|他快被嫉妬逼疯了
揃う|そろう|齐全|全員が揃ったら出発しよう|所有人到齐后再出发
からかう|からかう|逗弄、开玩笑|人をからかわないで|不要戏弄人
背負う|せおう|背；担负|彼は多くの責任を背負っている|他肩负着很多责任
擦れ違う|すれちがう|交错、擦肩而过；不一致，有分歧|彼と駅ですれ違った|和他在车站擦肩而过
仕舞う|しまう|收拾、结束|おもちゃをしまう|把玩具收拾起来
招く|まねく|邀请、招致|文化祭に歌手を招くのが恒例になっている。|邀请歌手演出是文化节的惯例。
響く|ひびく|回想；影响|トンネルの中は声がよく響く|隧道中回声很响
躓く|つまずく|跌跤、挫折|石につまずいて転んだ|被石头绊倒了
崩す|くずす|拆卸；弄乱|山を崩して道路を作る|拆山修路
刻む|きざむ|切；雕刻|ネギを細かく刻む|把葱切碎
萎む|しぼむ|凋萎|風船が萎んでしまった|气球瘪了
縮む|ちぢむ|缩小、缩短|服が縮んだ|衣服缩水了
睨む|にらむ|瞪眼|彼は怒って私を睨んだ|他生气地瞪着我
悔やむ|くやむ|懊悔、后悔|もっと勉強しなかったことを悔やんでいる|后悔没有多学习一点
迫る|せまる|迫近、接近|試験に迫る|考试临近
弄る|いじる|摆弄、鼓捣|髪の毛を弄っている|正在摆弄头发
偏る|かたよる|偏颇、偏向|彼の意見は偏っている|他的意見有失偏颇
潜る|もぐる|潜水；躲入|海に潜る|潜海
怠る|おこたる|懈怠、疏忽|仕事を怠って上司に叱られた|因怠慢工作被上司训斥
荒れる|あれる|荒芜；狂暴、天气恶劣；干燥、粗糙|海が荒れる|海上波涛汹涌
溢れる|あふれる|溢出、充满|元気溢れる|生机勃勃
溺れる|おぼれる|溺水；沉迷|川で溺れてしまった|在河里溺水了
ずれる|ずれる|移动、偏离|話がずれる|双方话题不一致
逸れる|それる|脱轨、偏离|話が本題から逸れてしまった|话题偏离了主题
拵える|こしらえる|制作、做|夕飯を拵える|做晚饭
訴える|うったえる|控告；诉说|彼は体の不調を訴えている|他诉说身体不适
抱える|かかえる|抱；负担，背负|荷物を抱えている|他抱着一个大包裹
備える|そなえる|防备、准备|備えるはとても大切です。|使用「備える」的例句：防备、准备很重要
備える|そなえる|防备、准备|災害に備えて食料を買っておく|为灾害准备好食物
衰える|おとろえる|衰退、減弱|体力が衰える|体力衰退
躾ける|しつける|教育，教养|子供を躾ける|教育孩子
ふざける|ふざける|开玩笑、戏弄|ふざけるのもいい加減にしろ|愚弄他人也要适可而止
途絶える|とだえる|中断、断绝|連絡が途絶える|联系断绝
やっつける|やっつける|打败、干完|彼は敵をやっつけた|他打败了敌人
くっつける|くっつける|使粘上|切手をのりでくっつける|用胶水粘上
言付ける|ことづける|托付|友達に手紙をことづけた|托朋友指信
差し引く|さしひく|扣除、减去|税金を差し引く|扣除税金
取り消す|とりけす|取消、作废|申し込みを取り消した|取消了申请
引き受ける|ひきうける|承担、接受保证|仕事を引き受けることにした|决定承担这项工作
争う|あらそう|争、争斗|これは争うです。|使用「争う」的例句：这是争、争斗
抗う|あらがう|抵抗、反抗|抗うを持っています。|使用「抗う」的例句：有抵抗、反抗
逆らう|さからう|违背、反抗|逆らうが好きです。|使用「逆らう」的例句：喜欢违背、反抗
抱く|だく、いだく|抱、怀抱|抱くを買いました。|使用「抱く」的例句：买了抱、怀抱
果たす|はたす|完成、实现|約束を果たす|履行约定
甘やかす|あまやかす|宠溺、纵容|子どもを甘やかす|溺爱孩子
挟む|はさむ|夹、插入|パンにハムを挟む|在面包中夹火腿
振る|ふる|挥动、摇摆|彼女に振られる|被女朋友甩了
劣る|おとる|不如、劣势|性能が劣る|性能较差
被る|かぶる|戴（帽子）、蒙受|帽子を被る|戴帽子
怠ける|なまける|懒惰、不努力|怠けるを持っています。|使用「怠ける」的例句：有懒惰、不努力
威張る|いばる|张狂、逞威风|偉そうに威張る|摆出一副了不起的样子
呆れる|あきれる|吃惊|あまりのひどさに呆れる|因太离谱而惊呆
乱れる|みだれる|混乱、紊乱|秩序が乱れる|秩序混乱
暴れる|あばれる|胡闹、大显身手|暴れるところです。|使用「暴れる」的例句：胡闹、大显身手的地方
整える|ととのえる|整理、准备|服装を整える|整理服装
改める|あらためる|改正、改善|態度を改める|改变态度
定める|さだめる|規定、決定|規則を定める|制定規則
納める|おさめる|缴纳、接受|税金を納める|缴纳税金
傾ける|かたむける|傾斜、傾注|耳を傾ける|側耳倾听
ぶつける|ぶつける|撞上、投掷|車を壁にぶつける|把车碰到墙上
任せる|まかせる|委托、托付|仕事を任せる|委托工作
溜まる|たまる|积攒、积累|ストレスが溜まる|积压压力
恵まれる|めぐまれる|受恩惠、富足|才能に恵まれる|天赋异禀
通じる|つうじる|通过、理解|日本語が通じる|能通日语
そそる|そそる|激起、引起|食欲をそそる|勾起食欲
くっつく|くっつく|緊貼、附着|ガムが靴にくっつく|口香糖粘到鞋子上
むかつく|むかつく|生气、反胃|あいつの態度にむかつく|被那家伙的态度气到
思い込む|おもいこむ|深信|思い込むを買いました。|使用「思い込む」的例句：买了深信
溶け込む|とけこむ|融合、融洽|溶け込むについて話します。|使用「溶け込む」的例句：谈论融合、融洽
乗り越える|のりこえる|克服、跨越|困難を乗り越える|克服困难
思い切る|おもいきる|下决心、断念|仕事を辞めると心に思い切る|下定決心辞职
当てはまる|あてはまる|适用、符合|条件に当てはまる|符合条件
打ち消す|うちけす|否认、消除|うわさを打ち消す|否认传言
打ち合わせる|うちあわせる|商量|時間を打ち合わせる|商定时间
問い合わせる|といあわせる|询问|会社に問い合わせる|咨询公司
張り切る|はりきる|干劲十足|新人が張り切って働く|新人干劲十足
仕上げる|しあげる|完成、做完|レポートを仕上げる|完成报告
戦う|たたかう|战斗、斗争|これは戦うです。|使用「戦う」的例句：这是战斗、斗争
奪う|うばう|夺取、剥夺|男は店員に刃物を突きつけ、現金を奪った|男子用刀威胁店员，抢走了现金
救う|すくう|拯救、救助|救うについて話します。|使用「救う」的例句：谈论拯救、救助
庇う|かばう|庇护、保护|庇うを持っています。|使用「庇う」的例句：有庇护、保护
拾う|ひろう|抱起、拾取|拾うを持っています。|使用「拾う」的例句：有抱起、拾取
疑う|うたがう|怀疑|疑うを買いました。|使用「疑う」的例句：买了怀疑
覆う|おおう|覆盖、笼罩|覆うを持っています。|使用「覆う」的例句：有覆盖、笼罩
養う|やしなう|养育、培养|養うを買いました。|使用「養う」的例句：买了养育、培养
補う|おぎなう|补充、弥补|補うはとても大切です。|使用「補う」的例句：补充、弥补很重要
這う|はう|爬，蠕动|時々這うます。|使用「這う」的例句：有时爬，蠕动
雇う|やとう|雇佣|これは雇うです。|使用「雇う」的例句：这是雇佣
伴う|ともなう|伴随、跟随|伴うについて話します。|使用「伴う」的例句：谈论伴随、跟随
敬う|うやまう|尊敬|目上の人を敬うことは大切だ|尊敬长辈是很重要的
祝う|いわう|祝贺、庆祝|祝うはとても大切です。|使用「祝う」的例句：祝贺、庆祝很重要
占う|うらなう|占卜、预言|占うについて話します。|使用「占う」的例句：谈论占卜、预言
請う|こう|请求、恳求|請うはとても大切です。|使用「請う」的例句：请求、恳求很重要
誘う|さそう|邀请、引诱|誘うを買いました。|使用「誘う」的例句：买了邀请、引诱
払う|はらう|支付、拂去|よく払うます。|使用「払う」的例句：经常支付、拂去
担う|になう|承担、背负|これは担うです。|使用「担う」的例句：这是承担、背负
躊躇う|ためらう|犹豫|会うのを躊躇っていた|犹豫着见还是不见
経つ|たつ|经过、流逝|これは経つです。|使用「経つ」的例句：这是经过、流逝
育つ|そだつ|成长、养育|育つ人です。|使用「育つ」的例句：成长、养育的人
保つ|たもつ|保持、维持|これは保つです。|使用「保つ」的例句：这是保持、维持
頷く|うなずく|点头、同意|頷くが好きです。|使用「頷く」的例句：喜欢点头、同意
驚く|おどろく|惊讶、吃惊|そのニュースに驚きました|对那个消息感到惊讶
暴く|あばく|揭露、揭发|これは暴くです。|使用「暴く」的例句：这是揭露、揭发
築く|きずく|修建、建立|築くはとても大切です。|使用「築く」的例句：修建、建立很重要
働く|はたらく|工作、起作用|時々働くます。|使用「働く」的例句：有时工作、起作用
傷つく|きずつく|受伤、损伤|傷つくについて話します。|使用「傷つく」的例句：谈论受伤、损伤
囁く|ささやく|低语、耳语|囁く人です。|使用「囁く」的例句：低语、耳语的人
乾く|かわく|干燥、变干|乾くを持っています。|使用「乾く」的例句：有干燥、变干
浮く|うく|浮起、漂浮|浮くを持っています。|使用「浮く」的例句：有浮起、漂浮
除く|のぞく|除去、去掉|今日は除くました。|使用「除く」的例句：今天除去、去掉了
抜く|ぬく|拔出、省去|一緒に抜くましょう。|使用「抜く」的例句：一起拔出、省去吧
導く|みちびく|引导、带领|導くを持っています。|使用「導く」的例句：有引导、带领
拭く|ふく|擦|机の上を布で拭いた|用布擦了桌子
省く|はぶく|省略、节省|むだを省く|避免浪费
俯く|うつむく|低头、俯视|俯く天気ですね。|使用「俯く」的例句：低头、俯视的天气呢
傾く|かたむく|倾斜、倾向|傾くを買いました。|使用「傾く」的例句：买了倾斜、倾向
長引く|ながびく|拖长、拖延|会議が長引いてしまった|会议超时了
騒ぐ|さわぐ|吵闹、喧哗|騒ぐを買いました。|使用「騒ぐ」的例句：买了吵闹、喧哗
跨ぐ|またぐ|跨过|跨ぐを買いました。|使用「跨ぐ」的例句：买了跨过
塞ぐ|ふさぐ|堵住、塞住|塞ぐについて話します。|使用「塞ぐ」的例句：谈论堵住、塞住
相次ぐ|あいつぐ|接连发生|新しい相次ぐです。|使用「相次ぐ」的例句：新的接连发生
注ぐ|そそぐ|注入|コップに水を注ぐ|往杯子里倒水
貸す|かす|借出、出租|これは貸すです。|使用「貸す」的例句：这是借出、出租
刺す|さす|刺、叮咬|刺すが好きです。|使用「刺す」的例句：喜欢刺、叮咬
許す|ゆるす|允许、原谅|許すについて話します。|使用「許す」的例句：谈论允许、原谅
離す|はなす|放开、分离|これは離すです。|使用「離す」的例句：这是放开、分离
壊す|こわす|破坏、弄坏|壊す人です。|使用「壊す」的例句：破坏、弄坏的人
外す|はずす|取下、离开|外すが好きです。|使用「外す」的例句：喜欢取下、离开
返す|かえす|归还、返回|返すはとても大切です。|使用「返す」的例句：归还、返回很重要
渡す|わたす|交给、递交|渡すを持っています。|使用「渡す」的例句：有交给、递交
足す|たす|添、加、补充|足すを買いました。|使用「足す」的例句：买了添、加、补充
訳す|やくす|翻译、解释|訳すを持っています。|使用「訳す」的例句：有翻译、解释
隠す|かくす|隐藏、遮掩|隠すはとても大切です。|使用「隠す」的例句：隐藏、遮掩很重要
略す|りゃくす|省略、简略|略すを持っています。|使用「略す」的例句：有省略、简略
直す|なおす|修理、改正|新しい直すです。|使用「直す」的例句：新的修理、改正
探す|さがす|寻找、搜寻|探すを買いました。|使用「探す」的例句：买了寻找、搜寻
倒す|たおす|弄倒、推翻|倒すについて話します。|使用「倒す」的例句：谈论弄倒、推翻
潰す|つぶす|弄碎、毁坏|とても潰すです。|使用「潰す」的例句：非常弄碎、毁坏
促す|うながす|促进、催促|インフルエンザが流行しているため、クラス全員に注意を促した|我提醒全班同学注意流感高发
試す|ためす|尝试|実力を試す|测试实力
干す|ほす|晒、弄干|洗濯物を外に干す|把洗好的衣服晾到外面
乾かす|かわかす|弄干、晾干|乾かすを買いました。|使用「乾かす」的例句：买了弄干、晾干
目指す|めざす|以…为目标|これは目指すです。|使用「目指す」的例句：这是以…为目标
暮らす|くらす|生活、度日|暮らすを持っています。|使用「暮らす」的例句：有生活、度日
落とす|おとす|弄掉、降低|落とす人です。|使用「落とす」的例句：弄掉、降低的人
減らす|へらす|減少、缩小|減らす人です。|使用「減らす」的例句：減少、缩小的人
なくす|なくす|丢失、消灭|なくすはとても大切です。|使用「なくす」的例句：丢失、消灭很重要
延ばす|のばす|延长、推迟|延ばすところです。|使用「延ばす」的例句：延长、推迟的地方
欠かす|かかす|缺少、欠缺|欠かすを持っています。|使用「欠かす」的例句：有缺少、欠缺
散らかす|ちらかす|弄乱、散乱|新しい散らかすです。|使用「散らかす」的例句：新的弄乱、散乱
屈む|かがむ|弯腰、蹲下|屈むが好きです。|使用「屈む」的例句：喜欢弯腰、蹲下
傷む|いたむ|损坏、腐烂|傷む天気ですね。|使用「傷む」的例句：损坏、腐烂的天气呢
拒む|こばむ|拒绝、阻挡|拒むを買いました。|使用「拒む」的例句：买了拒绝、阻挡
包む|つつむ|包裹、包围|大勢の人々の拍手に包まれながら、新郎新婦が登場した|在众人的掌声中，新郎新娘登场了
悩む|なやむ|烦恼、困扰|悩むを持っています。|使用「悩む」的例句：有烦恼、困扰
編む|あむ|编织|新しい編むです。|使用「編む」的例句：新的编织
憎む|にくむ|憎恨、厌恶|憎むについて話します。|使用「憎む」的例句：谈论憎恨、厌恶
済む|すむ|结束、完成|済むが好きです。|使用「済む」的例句：喜欢结束、完成
沈む|しずむ|沉没、消沉|沈むを買いました。|使用「沈む」的例句：买了沉没、消沉
囲む|かこむ|囲绕、包囲|久々に家族で鍋料理を囲み、団らんの時間を過ごした|一家人久违地围在一起吃火锅，享受团圆时光
汲む|くむ|汲取、打水|汲むはとても大切です。|使用「汲む」的例句：汲取、打水很重要
畳む|たたむ|折叠、收起|畳むが好きです。|使用「畳む」的例句：喜欢折叠、收起
恨む|うらむ|怨恨、痛恨|新しい恨むです。|使用「恨む」的例句：新的怨恨、痛恨
組む|くむ|联合、编织|これは組むです。|使用「組む」的例句：这是联合、编织
掴む|つかむ|抓住、掌握|掴むが好きです。|使用「掴む」的例句：喜欢抓住、掌握
積む|つむ|堆积、装载|積むを買いました。|使用「積む」的例句：买了堆积、装载
喜ぶ|よろこぶ|高兴、喜悦|喜ぶ気持ちです。|使用「喜ぶ」的例句：高兴、喜悦的心情
結ぶ|むすぶ|系、连接|結ぶを買いました。|使用「結ぶ」的例句：买了系、连接
語る|かたる|讲述、描述|新しい語るです。|使用「語る」的例句：新的讲述、描述
怒る|おこる|生气、愤怒|怒るはとても大切です。|使用「怒る」的例句：生气、愤怒很重要
困る|こまる|困扰、难办|困るを持っています。|使用「困る」的例句：有困扰、难办
配る|くばる|分配、分发|配るが好きです。|使用「配る」的例句：喜欢分配、分发
凍る|こおる|冻结、结冰|これは凍るです。|使用「凍る」的例句：这是冻结、结冰
濁る|にごる|浑浊、污浊|これは濁るです。|使用「濁る」的例句：这是浑浊、污浊
得る|える|得到、获得|得るが好きです。|使用「得る」的例句：喜欢得到、获得
縛る|しばる|捆绑、束缚|縛るを持っています。|使用「縛る」的例句：有捆绑、束缚
握る|にぎる|握、抓住|握るはとても大切です。|使用「握る」的例句：握、抓住很重要
限る|かぎる|限定、限制|限るを買いました。|使用「限る」的例句：买了限定、限制
掘る|ほる|挖掘、挖洞|掘るを持っています。|使用「掘る」的例句：有挖掘、挖洞
絞る|しぼる|拧、绞尽|これは絞るです。|使用「絞る」的例句：这是拧、绞尽
治る|なおる|痊愈、修复|治るはとても大切です。|使用「治る」的例句：痊愈、修复很重要
渡る|わたる|渡过、跨越|渡るについて話します。|使用「渡る」的例句：谈论渡过、跨越
曇る|くもる|阴天、模糊|曇るについて話します。|使用「曇る」的例句：谈论阴天、模糊
断る|ことわる|拒绝、事先通知|断るについて話します。|使用「断る」的例句：谈论拒绝、事先通知
焦る|あせる|焦急、着急|焦るを買いました。|使用「焦る」的例句：买了焦急、着急
競る|せる|竞拍、竞争|競るを持っています。|使用「競る」的例句：有竞拍、竞争
寄る|よる|靠近、顺便去|時々寄るます。|使用「寄る」的例句：有时靠近、顺便去
至る|いたる|到达、达到|至るを買いました。|使用「至る」的例句：买了到达、达到
誤る|あやまる|错误、弄错|誤るを買いました。|使用「誤る」的例句：买了错误、弄错
祈る|いのる|祈祷、祝愿|祈るが好きです。|使用「祈る」的例句：喜欢祈祷、祝愿
守る|まもる|保护、遵守|守るを買いました。|使用「守る」的例句：买了保护、遵守
折る|おる|折断、弯折|折るを買いました。|使用「折る」的例句：买了折断、弯折
尖る|とがる|尖|ナイフの刃は尖っている|刀刃很尖
腐る|くさる|腐烂、腐败|このりんごは腐っている|这个苹果已经烂了
削る|けずる|削；削减、缩减|鉛筆を削る|削铅笔
譲る|ゆずる|转让、让|席をお年寄りに譲った|把座位让给了老人
頼る|たよる|依赖|彼は親に頼って生活している|他依赖父母生活
濡れる|ぬれる|淋湿、沾湿|濡れるはとても大切です。|使用「濡れる」的例句：淋湿、沾湿很重要
汚れる|よごれる|弄脏、污染|汚れるについて話します。|使用「汚れる」的例句：谈论弄脏、污染
慣れる|なれる|习惯、适应|これは慣れるです。|使用「慣れる」的例句：这是习惯、适应
倒れる|たおれる|倒下、倒闭|倒れるが好きです。|使用「倒れる」的例句：喜欢倒下、倒闭
崩れる|くずれる|崩塌、瓦解|崩れるが好きです。|使用「崩れる」的例句：喜欢崩塌、瓦解
破れる|ヤブれる|破裂、破损|破れるはとても大切です。|使用「破れる」的例句：破裂、破损很重要
敗れる|ヤブれる|失敗、败北|敗れるが好きです。|使用「敗れる」的例句：喜欢失敗、败北
憧れる|あこがれる|憧憬、向往|都会生活に憧れて、田舎から東京に出てきた|因为向往都市生活，所以从乡下来到东京
折れる|おれる|折断、弯曲|これは折れるです。|使用「折れる」的例句：这是折断、弯曲
割れる|われる|破碎、裂开|手が滑ってワイングラスが割れてしまった|手滑把红酒杯摔碎了
離れる|はなれる|离开、分开|離れるはとても大切です。|使用「離れる」的例句：离开、分开很重要
疲れる|つかれる|疲劳、劳累|疲れるを買いました。|使用「疲れる」的例句：买了疲劳、劳累
訪れる|おとずれる|访问、到来|山田選手は各地を訪れ、熱烈な歡迎を受けた|山田选手访问各地，受到了热烈的欢迎
萎れる|しおれる|枯萎、萎蔫|萎れるを持っています。|使用「萎れる」的例句：有枯萎、萎蔫
枯れる|かれる|枯萎|花が枯れてしまった|花枯萎了
痺れる|しびれる|麻木、发麻|長時間正座して足が痺れた|跪坐久了，腿麻了
草臥れる|くたびれる|疲劳|すっかり草臥れた|累得不行
蓄える|たくわえる|储备|冬に向けて食料を蓄える|为冬天储备粮食
生える|はえる|生长|春になると草が生える|一到春天，草就会生长
支える|ささえる|支持、维持|家族を支える|支撑家庭
抑える|おさえる|压制、抑制|抑えるを買いました。|使用「抑える」的例句：买了压制、抑制
冷える|ひえる|变冷、变凉|冷えるところです。|使用「冷える」的例句：变冷、变凉的地方
与える|あたえる|给予、提供|与えるについて話します。|使用「与える」的例句：谈论给予、提供
供える|そなえる|供奉、供上|供えるが好きです。|使用「供える」的例句：喜欢供奉、供上
捕らえる|とらえる|抓住、捕捉|捕らえるを持っています。|使用「捕らえる」的例句：有抓住、捕捉
慰める|なぐさめる|安慰、慰问|友達を慰めた|安慰朋友
まとめる|まとめる|归纳、整理|レポートをまとめて提出した|整理好报告并提交了
固める|かためる|加固、坚定|これは固めるです。|使用「固める」的例句：这是加固、坚定
占める|しめる|占据、占有|占めるが好きです。|使用「占める」的例句：喜欢占据、占有
責める|せめる|责备、指责|責めるを持っています。|使用「責める」的例句：有责备、指责
埋める|うめる|填埋、填补|新しい埋めるです。|使用「埋める」的例句：新的填埋、填补
務める|つとめる|担任|これは務めるです。|使用「務める」的例句：这是担任
諦める|あきらめる|放弃、死心|これは諦めるです。|使用「諦める」的例句：这是放弃、死心
努める|つとめる|努力、尽力|努めるを買いました。|使用「努める」的例句：买了努力、尽力
縮める|ちぢめる|縮短、压缩|縮める人です。|使用「縮める」的例句：縮短、压缩的人
確かめる|たしかめる|确认|確かめるを買いました。|使用「確かめる」的例句：买了确认
教わる|おそわる|受教、跟…学习|先生に日本語を教わった|向老师学习了日语
授ける|さずける|授予、传授|授けるが好きです。|使用「授ける」的例句：喜欢授予、传授
儲ける|もうける|赚钱|彼は株で大金を儲けた|他靠炒股赚了很多钱
焦げる|こげる|焦、糊|魚が焦げてしまった|鱼烧糊了
捨てる|すてる|丢弃、抛弃|捨てるはとても大切です。|使用「捨てる」的例句：丢弃、抛弃很重要
隔てる|へだてる|隔开、分隔|これは隔てるです。|使用「隔てる」的例句：这是隔开、分隔
慌てる|あわてる|慌张、急忙|慌てるはとても大切です。|使用「慌てる」的例句：慌张、急忙很重要
束ねる|たばねる|束起、管理|束ねるを買いました。|使用「束ねる」的例句：买了束起、管理
跳ねる|はねる|跳跃；飞溅|魚が跳ねる|鱼跃起来了
預ける|あずける|托付、存放|これは預けるです。|使用「預ける」的例句：这是托付、存放
散らかる|ちらかる|乱、凌乱|散らかるについて話します。|使用「散らかる」的例句：谈论乱、凌乱
可愛がる|かわいがる|喜爱、疼爱|猫を可愛がっている|疼爱小猫咪
怖がる|こわがる|害怕、畏惧|これは怖がるです。|使用「怖がる」的例句：这是害怕、畏惧
当たる|あたる|中、命中|当たるが好きです。|使用「当たる」的例句：喜欢中、命中
含まれる|ふくまれる|包含、含有|これは含まれるです。|使用「含まれる」的例句：这是包含、含有
捕まえる|つかまえる|抓住、逮捕|これは捕まえるです。|使用「捕まえる」的例句：这是抓住、逮捕
詰まる|つまる|塞满、堵住|詰まるを持っています。|使用「詰まる」的例句：有塞满、堵住
埋まる|うまる|被埋、填满|埋まるが好きです。|使用「埋まる」的例句：喜欢被埋、填满
閉じる|とじる|关闭|ドアを閉じる|关门
飽きる|あきる|腻烦、足够|仕事にあきる|对工作厌烦
尽きる|つきる|用尽、穷尽|尽きるを買いました。|使用「尽きる」的例句：买了用尽、穷尽
裏切る|うらぎる|背叛、辜负|彼は仲間を裏切った|他背叛了同伴
借りる|かりる|借入、租借|借りるが好きです。|使用「借りる」的例句：喜欢借入、租借
錆びる|さびる|生锈、腐蚀|錆びるが好きです。|使用「錆びる」的例句：喜欢生锈、腐蚀
思いつく|おもいつく|想起、想到|思いつくが好きです。|使用「思いつく」的例句：喜欢想起、想到
落ち着く|おちつく|沉着、镇定|まずは落ち着いて話を聞こう|先冷静下来听对方说
引っ掛かる|ひっかかる|挂上、受骗|服が釘に引っ掛かった|衣服被钉子挂住了
話しかける|はなしかける|搭话|話しかけるを持っています。|使用「話しかける」的例句：有搭话
話しかける|はなしかける|搭话|彼は私に話し掛けてきた|他主动跟我搭话
追いかける|おいかける|追赶|犬が猫を追いかけている|狗在追猫
落ち込む|おちこむ|陷入、消沉|落ち込むはとても大切です。|使用「落ち込む」的例句：陷入、消沉很重要
詰め込む|つめこむ|塞进、填满|詰め込むはとても大切です。|使用「詰め込む」的例句：塞进、填满很重要
割り込む|わりこむ|插队、打断|割り込むについて話します。|使用「割り込む」的例句：谈论插队、打断
突っ込む|つっこむ|深入；插入|新しい突っ込むです。|使用「突っ込む」的例句：新的深入；插入
追い込む|おいこむ|逼入、迫使|追い込むが好きです。|使用「追い込む」的例句：喜欢逼入、迫使
見張る|みはる|监视、看守|一緒に見張るましょう。|使用「見張る」的例句：一起监视、看守吧
見渡す|みわたす|环视、远眺|見渡すについて話します。|使用「見渡す」的例句：谈论环视、远眺
見分ける|みわける|辨别、区分|見分けるについて話します。|使用「見分ける」的例句：谈论辨别、区分
思い出す|おもいだす|想起、回忆|思い出すを買いました。|使用「思い出す」的例句：买了想起、回忆
差し支える|さしつかえる|妨碍、阻碍|これは差し支えるです。|使用「差し支える」的例句：这是妨碍、阻碍
入れ替える|いれかえる|更换、调换|入れ替えるが好きです。|使用「入れ替える」的例句：喜欢更换、调换
関わり合う|かかわりあう|有关联|関わり合うを買いました。|使用「関わり合う」的例句：买了有关联
買い占める|かいしめる|囤积、买断|よく買い占めるます。|使用「買い占める」的例句：经常囤积、买断
呼び止める|よびとめる|叫住|呼び止めるが好きです。|使用「呼び止める」的例句：喜欢叫住
振り返る|ふりかえる|回头看、回顾|今日は振り返るました。|使用「振り返る」的例句：今天回头看、回顾了
付け加える|つけくわえる|补充|これは付け加えるです。|使用「付け加える」的例句：这是补充
取り入れる|とりいれる|吸收|取り入れるを買いました。|使用「取り入れる」的例句：买了吸收
取り扱う|とりあつかう|操作、对待|新しい取り扱うです。|使用「取り扱う」的例句：新的操作、对待
取り組む|とりくむ|埋头、热心于|今年は猪突猛進、何事にも積極的に取り組むつもりだ|今年要勇往直前，积极应对一切挑战
受け取る|うけとる|收到、接收|受け取るが好きです。|使用「受け取る」的例句：喜欢收到、接收
受け入れる|うけいれる|接受、采纳|受け入れるが好きです。|使用「受け入れる」的例句：喜欢接受、采纳
受け持つ|うけもつ|担任，负责|受け持つについて話します。|使用「受け持つ」的例句：谈论担任，负责
引き止める|ひきとめる|挽留|引き止めるはとても大切です。|使用「引き止める」的例句：挽留很重要
聞き取る|ききとる|听懂、听清|聞き取ることができます。|使用「聞き取る」的例句：能够听懂、听清
振り向く|ふりむく|回头、回顾|振り向くについて話します。|使用「振り向く」的例句：谈论回头、回顾
通りかかる|とおりかかる|碰巧路过|今偶然通りかかった人は私の知り合いです|刚才偶然路过的人是我的熟人
通り過ぎる|とおりすぎる|走过、越过|バスは私の前を通り過ぎた|公交车从我面前驶过
立て替える|たてかえる|垫付|新しい立て替えるです。|使用「立て替える」的例句：新的垫付
書き留める|かきとめる|记下，写下|時々書き留めるます。|使用「書き留める」的例句：有时记下，写下
払い戻す|哈らいもどす|退还|払い戻すを持っています。|使用「払い戻す」的例句：有退还
抱きしめる|だきしめる|抱紧|これは抱きしめるです。|使用「抱きしめる」的例句：这是抱紧
押し寄せる|おしよせる|蜂拥而至|押し寄せるを持っています。|使用「押し寄せる」的例句：有蜂拥而至

【形容词篇】
辛い|からい|辛的、辛辣的|辛い気持ちです。|使用「辛い」的例句：辛的、辛辣的的心情
辛い|つらい|辛苦、痛苦|辛い人です。|使用「辛い」的例句：辛苦、痛苦的人
狭い|せまい|狭窄的|狭い天気ですね。|使用「狭い」的例句：狭窄的的天气呢
苦しい|くるしい|痛苦的、难受的|苦しいところです。|使用「苦しい」的例句：痛苦的、难受的的地方
明るい|あかるい|明亮的、光明的|明るい天気ですね。|使用「明るい」的例句：明亮的、光明的的天气呢
暗い|くらい|阴暗的、阴郁的|暗いところです。|使用「暗い」的例句：阴暗的、阴郁的的地方
淡い|あわい|淡的、浅的|淡いところです。|使用「淡い」的例句：淡的、浅的的地方
恥ずかしい|はずかしい|害羞的、难为情的|恥ずかしい人です。|使用「恥ずかしい」的例句：害羞的、难为情的的人
熱い|あつい|热的、热烈的|熱い天気ですね。|使用「熱い」的例句：热的、热烈的的天气呢
温い|ぬるい|微温的、不凉的|スープが温くなってしまった|汤变得不热了
暑い|あつい|炎热的、闷热的|今日はとても暑いです|今天很热
寒い|さむい|寒冷的、阴凉的|冬は寒いです|冬天很冷
冷たい|つめたい|冷的、凉的|冷たい気持ちです。|使用「冷たい」的例句：冷的、凉的的心情
温かい|あたたかい|温暖的、热情的|温かい人です。|使用「温かい」的例句：温暖的、热情的的人
古い|ふるい|旧的、老的|とても古いです。|使用「古い」的例句：非常旧的、老的
新しい|あたらしい|新的、新鲜的|新しいところです。|使用「新しい」的例句：新的、新鲜的的地方
怖い|こわい|可怕的、恐怖的|怖い気持ちです。|使用「怖い」的例句：可怕的、恐怖的的心情
恐ろしい|おそろしい|可怕的、骇人的|とても恐ろしいです。|使用「恐ろしい」的例句：非常可怕的、骇人的
可笑しい|おかしい|奇怪的、滑稽的|可笑しい人です。|使用「可笑しい」的例句：奇怪的、滑稽的的人
悲しい|かなしい|悲伤的、伤感的|悲しい映画でした|是悲伤的电影
寂しい|さびしい|孤单的、寂寞的|寂しい気持ちです。|使用「寂しい」的例句：孤单的、寂寞的的心情
緩い|ゆるい|松弛的、宽松的|とても緩いです。|使用「緩い」的例句：非常松弛的、宽松的
鈍い|にぶい|钝；迟缓、愚钝；暗淡；沙哑|鈍いところです。|使用「鈍い」的例句：钝；迟缓、愚钝；暗淡；沙哑的地方
鋭い|するどい|尖锐的、敏锐的|遺産を巡る兄弟の鋭い争いが起こった|兄弟之间围绕遗产爆发了激烈的争执
敏い|さとい|敏锐的、敏感的|敏い人です。|使用「敏い」的例句：敏锐的、敏感的的人
くどい|くどい|啰嗦的；油腻的；过于强烈|くどい説明|啰嗦的说明
ずるい|ずるい|狡猾的|そのやり方はずるい|那种做法是在耍滑
きつい|きつい|严厉的、严格的|きつい人です。|使用「きつい」的例句：严厉的、严格的的人
危うい|あやうい|危险的|危ういところを助けられる|在危险关头得救
有難い|ありがたい|难得的、值得感谢的|有難い気持ちです。|使用「有難い」的例句：难得的、值得感谢的的心情
力強い|ちからづよい|强有力的|力強い天気ですね。|使用「力強い」的例句：强有力的的天气呢
分厚い|ぶあつい|厚实的|分厚いところです。|使用「分厚い」的例句：厚实的的地方
薄暗い|うすぐらい|阴暗的|とても薄暗いです。|使用「薄暗い」的例句：非常阴暗的
心弱い|こころよわい|胆怯的|心弱い天気ですね。|使用「心弱い」的例句：胆怯的的天气呢
心強い|こころづよい|有信心、有底气|とても心強いです。|使用「心強い」的例句：非常有信心、有底气
心細い|こころぼそい|没底气、不安|心細い天気ですね。|使用「心細い」的例句：没底气、不安的天气呢
気弱い|きよわい|胆小的、懦弱的|気弱いところです。|使用「気弱い」的例句：胆小的、懦弱的的地方
気強い|きづよい|心里踏实|気強い気持ちです。|使用「気強い」的例句：心里踏实的心情
根気強い|こんきづよい|有耐心|根気強い人です。|使用「根気強い」的例句：有耐心的人
意地悪い|いじわるい|恶意的|意地悪い人です。|使用「意地悪い」的例句：恶意的的人
面倒臭い|めんどうくさい|麻烦的、费事的|この作業は面倒臭い|这个工作很麻烦
蒸し暑い|むしあつい|闷热的|蒸し暑くて寝苦しい|闷热得令人难以入睡
めでたい|めでたい|值得祝贺的、幸运的|合格して、何よりもめでたい|考试合格是更值得可喜可贺
うるさい|うるさい|吵闹的、烦人的|とてもうるさいです。|使用「うるさい」的例句：非常吵闹的、烦人的
しつこい|しつこい|执拗的、纠缠不休的|しつこい天気ですね。|使用「しつこい」的例句：执拗的、纠缠不休的的天气呢
かっこいい|かっこいい|帅气的、酷的|かっこいい人です。|使用「かっこいい」的例句：帅气的、酷的的人
悔しい|くやしい|懊悔的、不甘心|悔しい天気ですね。|使用「悔しい」的例句：懊悔的、不甘心的天气呢
優しい|やさしい|温柔的、和善的|優しい天気ですね。|使用「優しい」的例句：温柔的、和善的的天气呢
著しい|いちじるしい|显著的|著しいところです。|使用「著しい」的例句：显著的的地方
眩しい|まぶしい|耀眼的、刺眼的|とても眩しいです。|使用「眩しい」的例句：非常耀眼的、刺眼的
嬉しい|うれしい|高兴的、开心的|とても嬉しいニュースです|是非常高兴的消息
苦しい|くるしい|痛苦的、困难的|苦しい天気ですね。|使用「苦しい」的例句：痛苦的、困难的的天气呢
珍しい|めずらしい|稀奇的、少见的|珍しい気持ちです。|使用「珍しい」的例句：稀奇的、少见的的心情
親しい|したしい|亲近的、熟悉的|親しい天気ですね。|使用「親しい」的例句：亲近的、熟悉的的天气呢
厳しい|きびしい|严格的、严厉的|厳しい気持ちです。|使用「厳しい」的例句：严格的、严厉的的心情
寂しい|さびしい|寂寞的、孤单的|寂しいところです。|使用「寂しい」的例句：寂寞的、孤单的的地方
惜しい|おしい|含不得的、可惜的|命が惜しい|珍惜生命
虚しい|むなしい|空虚的、徒劳的|とても虚しいです。|使用「虚しい」的例句：非常空虚的、徒劳的
詳しい|くわしい|详细的、精通的|詳しい人です。|使用「詳しい」的例句：详细的、精通的的人
貧しい|まずしい|贫穷的、贫乏的|貧しい気持ちです。|使用「貧しい」的例句：贫穷的、贫乏的的心情
乏しい|とぼしい|贫乏的、缺乏的|乏しい気持ちです。|使用「乏しい」的例句：贫乏的、缺乏的的心情
逞しい|たくましい|魁梧的、强健的|逞しいところです。|使用「逞しい」的例句：魁梧的、强健的的地方
喧しい|やかましい|吵闹的、喧嚷的|喧しい天気ですね。|使用「喧しい」的例句：吵闹的、喧嚷的的天气呢
等しい|ひとしい|相同的、一样的|それは罪に等しい|那和犯罪没什么区别
険しい|けわしい|险峻的、险恶的|険しい山道|险峻的山路
激しい|はげしい|强烈的、猛烈的|台風の影響で雨が激しく降っている|受台风影响，雨下得很大
怪しい|あやしい|可疑的、奇怪的|窓に怪しい人影が映り、思わず声を上げた|窗户上有可疑的人影，我不由自主喊了出来
可笑しい|おかしい|可笑的、奇怪的|可笑しい人です。|使用「可笑しい」的例句：可笑的、奇怪的的人
大人しい|おとなしい|老实的、温顺的|とても大人しいです。|使用「大人しい」的例句：非常老实的、温顺的
相応しい|ふさわしい|适合的、相称的|相応しい気持ちです。|使用「相応しい」的例句：适合的、相称的的心情
恐ろしい|おそろしい|可怕的、惊人的|恐ろしい天気ですね。|使用「恐ろしい」的例句：可怕的、惊人的的天气呢
懐かしい|なつかしい|怀念的、留恋的|懐かしい天気ですね。|使用「懐かしい」的例句：怀念的、留恋的的天气呢
輝かしい|かがやかしい|辉煌的|輝かしいところです。|使用「輝かしい」的例句：辉煌的的地方
甚だしい|はなはだしい|非常、甚|非常識も甚だしい|非常无知
重苦しい|おもくるしい|沉重的、压抑的|重苦しい気持ちです。|使用「重苦しい」的例句：沉重的、压抑的的心情
痛ましい|いたましい|令人痛心的|痛ましい気持ちです。|使用「痛ましい」的例句：令人痛心的的心情
勇ましい|いさましい|勇敢的|彼は勇ましく戦った|他勇敢地战斗了
羨ましい|うらやましい|羨慕的|とても羨ましいです。|使用「羨ましい」的例句：非常羨慕的
目覚ましい|めざましい|显著的、惊人的|目覚ましい人です。|使用「目覚ましい」的例句：显著的、惊人的的人
騒がしい|さわがしい|吵闹的|教室が騒がしい|教室里很吵闹
騒々しい|そうぞうしい|吵闹的|騒々しい雰囲気|喧闹的气氛
弱々しい|よわよわしい|非常虚弱的|弱々しい気持ちです。|使用「弱々しい」的例句：非常虚弱的的心情
図々しい|ずうずうしい|厚顔无耻的|彼は図々しく順番を抜かした|他厚顔无耻地插队了
厚かましい|あつかましい|厚脸皮的|厚かましい人です。|使用「厚かましい」的例句：厚脸皮的的人
恥ずかしい|はずかしい|羞耻、难为情|恥ずかしいところです。|使用「恥ずかしい」的例句：羞耻、难为情的地方
憎らしい|にくらしい|讨厌的、可恨的|彼の態度が憎らしい|他的态度真让人讨厌
頼もしい|たのもしい|可靠的、有前途的|彼の存在はとても頼もしい|他的存在让人很安心
馬鹿らしい|ばからしい|无聊的、愚蠢的|そんな馬鹿らしい話は信じられない|那种荒唐的故事无法相信
慌ただしい|あわただしい|匆忙的、慌忙的|彼は、電話を切ると慌ただしく部屋を出ていった|他挂完电话后慌慌张张地离开了房间
そそっかしい|そそっかしい|冒失的、粗心大意的|彼女はそそっかしくてよく物を落とす|她很冒失，经常掉东西
だらしない|だらしない|不检点、散漫；无度的|部屋はだらしなく散らかっている|房间凌乱不堪
つまらない|つまらない|无聊的|つまらない気持ちです。|使用「つまらない」的例句：无聊的的心情
仕方ない|しかたない|没办法|仕方ない天気ですね。|使用「仕方ない」的例句：没办法的天气呢
危ない|あぶない|危险的、不稳的|危ないところです。|使用「危ない」的例句：危险的、不稳的的地方
限りない|かぎりない|无限的|限りない人です。|使用「限りない」的例句：无限的的人
勿体ない|もったいない|可惜的|まだ使えるものを捨てるのは勿体ない|扔掉还能用的东西太可惜了
情けない|なさけない|可怜的、没出息的|情けない天気ですね。|使用「情けない」的例句：可怜的、没出息的的天气呢
やむを得ない|やむをえない|无可奈何的|やむを得ない決断|无可奈何的决定
みっともない|みっともない|难看的、不体面的|そんなみっともない格好で外に出るな|不要穿得那么难看就出门
とんでもない|とんでもない|出乎意料、不合情理|とんでもない発言をしてしまった|说出了荒唐的话
思いがけない|おもいがけない|意外的|思いがけない出会い|意外的相遇
物足りない|ものたりない|不够的、不足的|物足りない天気ですね。|使用「物足りない」的例句：不够的、不足的的天气呢
静か|しずか|安静的、平稳的|静か気持ちです。|使用「静か」的例句：安静的、平稳的的心情
豊か|ゆたか|丰富的、富裕的|豊か気持ちです。|使用「豊か」的例句：丰富的、富裕的的心情
明らか|あきらか|明确的、明显的|とても明らかです。|使用「明らか」的例句：非常明确的、明显的
滑らか|なめらか|光滑的、流畅的|滑らか気持ちです。|使用「滑らか」的例句：光滑的、流畅的的心情
なだらか|なだらか|坡度小的、不陡的|なだらかな坂|缓坡
柔らか|やわらか|柔软的、温和的|柔らか天気ですね。|使用「柔らか」的例句：柔软的、温和的的天气呢
細やか|こまやか|細膩、细致；深厚、浓厚|これは細やかです。|使用「細やか」的例句：这是細膩、细致；深厚、浓厚
緩やか|ゆるやか|緩慢的、宽松的|緩やか人です。|使用「緩やか」的例句：緩慢的、宽松的的人
和やか|なごやか|和睦的、温和的|和やかな雰囲気|和睦的气氛
穏やか|おだやか|平静的；温和、安详|穏やか人です。|使用「穏やか」的例句：平静的；温和、安详的人
晴れやか|はれやか|晴朗、明朗|これは晴れやかです。|使用「晴れやか」的例句：这是晴朗、明朗
爽やか|さわやか|爽快的、清爽的|朝の空気は爽やかだ|早晨的空气很清爽
にぎやか|にぎやか|热闹的、繁华的|にぎやか人です。|使用「にぎやか」的例句：热闹的、繁华的的人
鮮やか|あざやか|鲜艳、鲜明|鮮やかについて話します。|使用「鮮やか」的例句：谈论鲜艳、鲜明
大まか|おおまか|粗略的、大致的|とても大まかです。|使用「大まか」的例句：非常粗略的、大致的
嫌|いや|讨厌的、不喜欢的|嫌ところです。|使用「嫌」的例句：讨厌的、不喜欢的的地方
稀|まれ|罕见的、稀少的|稀人です。|使用「稀」的例句：罕见的、稀少的的人
勝手|かって|随便的、任性的|勝手天気ですね。|使用「勝手」的例句：随便的、任性的的天气呢
利口|りこう|聪明、机智|利口を買いました。|使用「利口」的例句：买了聪明、机智
複雑|ふくざつ|复杂的|とても複雑です。|使用「複雑」的例句：非常复杂的
敏感|びんかん|敏感、灵敏|肌が敏感なので、化粧品に気を遣っている|由于皮肤敏感，所以用化妆品比较注意
慎重|しんちょう|慎重的、小心的、谨慎的|新入社員の採用試験で、誰を合格とするか慎重に協議した|新员工招聘考试时，慎重地讨论要让谁合格
粗末|そまつ|粗糙的、简陋的；不重视、不尊重|粗末な食事|簡陋的饭菜
適当|てきとう|适当的、恰当的|適当な判断|恰当的判断
見事|みごと|好看；精彩|見事な花|漂亮的花
派手|はで|鲜艳的、花哨的|派手なデザイン|花哨的设计
地味|じみ|朴素的、朴实的|彼の服装は地味だ|他的衣着很朴素
卑怯|ひきょう|怯懦的、卑鄙的|卑怯なやり方|卑鄙的做法
物騒|ぶっそう|危险的；不安定的|最近、この辺りは物騒だから気をつけて帰ってね|最近这一带不太安全，回家时要注意
惨め|みじめ|悲惨的、凄惨的|惨めな生活|悲惨的生活
厄介|やっかい|麻烦的、难对付的|厄介な問題|棘手的问题
快適|かいてき|舒适的、舒畅的|このソファは快適だ|这个沙发很舒适
器用|きよう|灵巧的、巧妙的|彼女は手先が器用だ|她的手很灵巧
強引|ごういん|强行的、强制的|彼は強引に契約を結ばせた|他强行让对方签了合同
正直|しょうじき|诚实的、老实的|正直に言えば……|老实说……
下品|げひん|下流的、庸俗的|彼の発言は下品だった|他的话很低俗
上品|じょうひん|雅致的|彼女の振る舞いは上品だ|她的举止很优雅
率直|そっちょく|坦率的、直率的|率直に感想を言う|坦率地说出感想
真剣|しんけん|认真、真挚|これは真剣です。|使用「真剣」的例句：这是认真、真挚
質素|しっそ|简朴、简素|質素を買いました。|使用「質素」的例句：买了简朴、简素
素直|すなお|坦率、直率|これは素直です。|使用「素直」的例句：这是坦率、直率
軽快|けいかい|轻快、愉快|とても軽快です。|使用「軽快」的例句：非常轻快、愉快
手軽|てがる|轻松、简便|手軽について話します。|使用「手軽」的例句：谈论轻松、简便
手頃|てごろ|适合的|この商品は値段が手頃だ|这个商品的价格合适
陽気|ようき|爽朗的、快活的|陽気な性格|性格开朗
呑気|のんき|漫不经心的、悠闲的|彼は呑気にテレビを見ている|他悠闲地看着电视
気軽|きがる|轻松、愉快|気軽天気ですね。|使用「気軽」的例句：轻松、愉快的天气呢
気楽|きらく|轻松的、安逸的|気楽に考えたほうがいい|最好轻松地去想
生意気|なまいき|自大的、骄傲的|彼は生意気な態度をとる|他表現得很自大
気の毒|きのどく|可怜的、可悲的|病気の話を聞いて気の毒に思った|听到生病的消息，觉得很可怜
欲張り|よくばり|贪婪的、贪得无厌的|彼は欲張りで何でも欲しがる|他贪婪得什么都想要
出鱈目|でたらめ|荒唐的、胡闹的|出鱈目な発言|荒唐的发言
可哀想|かわいそう|可怜的|可哀想人です。|使用「可哀想」的例句：可怜的的人
不思議|ふしぎ|不可思议的、奇妙的|不思議ところです。|使用「不思議」的例句：不可思议的、奇妙的的地方
圧倒的|あっとうてき|圧倒性的、巨大的|圧倒的な人気|很受欢迎
抽象的|ちゅうしょうてき|抽象的|彼の説明は抽象的で具体性に欠ける|他的解释太抽象，不够具体
いい加減|いいかげん|适可而止；敷衍、不负责任的|いい加減ところです。|使用「いい加減」的例句：适可而止；敷衍、不负责任的的地方
哀れ|あわれ|悲惨，可怜|哀れな話|悲惨的故事
盛ん|さかん|热烈，繁盛|この地域では、学校の垣根を越えた交流が盛んだ|在这个地区，学校之间的交流十分活跃
大げさ|おおげさ|夸张的、夸大其词的|大げさ人です。|使用「大げさ」的例句：夸张的、夸大其词的的人
大雑把|おおざっぱ|草率的、粗略的|大雑把な計画|草率的计划
おしゃれ|おしゃれ|时尚的|おしゃれ人です。|使用「おしゃれ」的例句：时尚的的人
あやふや|あやふや|模糊的、不明确的|あやふや人です。|使用「あやふや」的例句：模糊的、不明确的的人
わがまま|わがまま|任性的、自私的|とてもわがままです。|使用「わがまま」的例句：非常任性的、自私的

【外来词篇】
アウト|out|出局、外部|アウトについて話します。|使用「アウト」的例句：谈论出局、外部
アクシデント|accident|事故、意外|アクシデントについて話します。|使用「アクシデント」的例句：谈论事故、意外
アクション|action|行动、动作|よくアクションます。|使用「アクション」的例句：经常行动、动作
アピール|appeal|吸引、呼吁|新しいアピールです。|使用「アピール」的例句：新的吸引、呼吁
アプローチ|approach|方法、接近|アプローチはとても大切です。|使用「アプローチ」的例句：方法、接近很重要
アポ|appointment|约会、见面|3時にアポを入れる|约在3点
アマチュア|amateur|业余爱好者、外行|アマチュアところです。|使用「アマチュア」的例句：业余爱好者、外行的地方
アルファベット|alphabet|字母表|アルファベットが好きです。|使用「アルファベット」的例句：喜欢字母表
アレルギー|allergie|过敏|アレルギーはとても大切です。|使用「アレルギー」的例句：过敏很重要
アレンジ|arrange|安排、改编|アレンジが好きです。|使用「アレンジ」的例句：喜欢安排、改编
イラスト|illustration|插画、图解|イラストを買いました。|使用「イラスト」的例句：买了插画、图解
インストール|install|安装|インストールを買いました。|使用「インストール」的例句：买了安装
インタビュー|interview|采访|有名な俳優にインタビューする|采访一位著名的演员
インテリア|interior|室内装饰|新しいインテリアです。|使用「インテリア」的例句：新的室内装饰
インパクト|impact|影响、冲击|これはインパクトです。|使用「インパクト」的例句：这是影响、冲击
インフレ|inflation|通货膨胀|インフレが好きです。|使用「インフレ」的例句：喜欢通货膨胀
ウイルス|virus|病毒|コンピューターウイルスに感染した|感染了电脑病毒
エネルギー|energy|能源、能量|再生可能エネルギーを活用する|利用可再生能源
エラー|error|错误|エラーはとても大切です。|使用「エラー」的例句：错误很重要
エンジン|engine|引擎|車のエンジンをかける|启动汽车引擎
オーバー|over|超过；夸大的、夸张的|予算をオーバーする|超预算
ガイド|guide|指南、导游|ガイドを買いました。|使用「ガイド」的例句：买了指南、导游
カタログ|catalogue|商品目录|新しい商品のカタログを取り寄せる|调取新产品目录
カテゴリー|category|范畴|本のカテゴリー|书的类别
カバー|cover|套子、壳；覆盖；补偿、弥补|赤字をカバーする|弥补赤字
カレンダー|calendar|日历|来年のカレンダーを買う|买明年的日历
キャンセル|cancel|取消|キャンセルが好きです。|使用「キャンセル」的例句：喜欢取消
キャンプ|camp|露营、帐篷|週末に家族でキャンプに行く|周末和家人去露营
クリア|clear|清晰的|クリア人です。|使用「クリア」的例句：清晰的的人
クリーニング|cleaning|清洗；干洗|スーツをクリーニングに出す|把西装送去干洗
クリック|click|点击、单击|スタートボタンをクリックする|点击开始键
ケア|care|关心、护理|ケアについて話します。|使用「ケア」的例句：谈论关心、护理
ゲスト|guest|客人、嘉宾|新しいゲストです。|使用「ゲスト」的例句：新的客人、嘉宾
コーチ|coach|教练|サッカーのコーチ|足球教练
ゴール|goal|目标、进球|新しいゴールです。|使用「ゴール」的例句：新的目标、进球
コメント|comment|评论、见解|彼の発言に対してコメントを控えます|对于他的发言，我不作评论
コレクション|collection|收集、收藏品|切手をコレクションしている|收集邮票
コンテスト|contest|比赛、竞赛|料理コンテストに参加する|参加烹饪比赛
コントロール|control|控制、调节|感情をコントロールする|控制情绪
サイン|sign|签名；信号|契約書にサインをする|在合同上签名
サポート|support|支持、援助|サポートが好きです。|使用「サポート」的例句：喜欢支持、援助
シーズン|season|季节|桜のシーズンがやってきた|樱花季到来了
シート|seat|座位、座席|電車の優先シートに座る|坐在电车的优先座位上
ショック|shock|震惊、冲击|ショックが好きです。|使用「ショック」的例句：喜欢震惊、冲击
シリーズ|series|系列；丛书|シリーズ作品|系列作品
シンプル|simple|简单、朴素|シンプルを買いました。|使用「シンプル」的例句：买了简单、朴素
スケジュール|schedule|日程；日程表|来週のスケジュールを確認する|确认下周的日程
ステージ|stage|舞台、阶段|ステージはとても大切です。|使用「ステージ」的例句：舞台、阶段很重要
ステップ|step|步骤、台阶|ステップを買いました。|使用「ステップ」的例句：买了步骤、台阶
ストライキ|strike|罢工|これはストライキです。|使用「ストライキ」的例句：这是罢工
ストレス|stress|压力、紧张|新しいストレスです。|使用「ストレス」的例句：新的压力、紧张
ストロー|straw|吸管|ジュースをストローで飲む|用吸管喝果汁
スピーチ|speech|演讲、讲话|スピーチを買いました。|使用「スピーチ」的例句：买了演讲、讲话
スペース|space|空间|新しいスペースです。|使用「スペース」的例句：新的空间
スマート|smart|苗条、漂亮|新しいスマートです。|使用「スマート」的例句：新的苗条、漂亮
スムーズ|smooth|平滑、流畅|スムーズはとても大切です。|使用「スムーズ」的例句：平滑、流畅很重要
スライド|slide|幻灯片；调整；滑动|プレゼンのスライドを作る|制作展示用的PPT
セット|set|组、布置|これはセットです。|使用「セット」的例句：这是组、布置
ゼミ|seminar|课堂讨论、研讨会|これはゼミです。|使用「ゼミ」的例句：这是课堂讨论、研讨会
セロテープ|cello tape|透明胶带|これはセロテープです。|使用「セロテープ」的例句：这是透明胶带
センス|sense|感觉、感受力|彼はファッションのセンスがいい|他很有时尚品味
ソフト|soft|柔软的；软件|新しいソフトをインストールする|安装新的软件
ターゲット|target|目标、对象|新しいターゲットです。|使用「ターゲット」的例句：新的目标、对象
タイトル|title|标题、题目|本のタイトルを決める|决定书的标题
タイミング|timing|时机、时序|タイミングが好きです。|使用「タイミング」的例句：喜欢时机、时序
タイム|time|时间|タイムを持っています。|使用「タイム」的例句：有时间
ダウン|down|下降、下落|ダウンが好きです。|使用「ダウン」的例句：喜欢下降、下落
ダメージ|damage|伤害、损害|これはダメージです。|使用「ダメージ」的例句：这是伤害、损害
タレント|talent|演员、艺人|タレントが好きです。|使用「タレント」的例句：喜欢演员、艺人
チーム|team|队；团队|野球のチームに入る|加入棒球队
チェンジ|change|变化、兑换|チェンジについて話します。|使用「チェンジ」的例句：谈论变化、兑换
チャージ|charge|充电、收费|チャージを買いました。|使用「チャージ」的例句：买了充电、收费
チャンス|chance|机会|これはチャンスです。|使用「チャンス」的例句：这是机会
データ|data|数据|重要なデータを保存する|保存重要数据
テクニック|technique|技巧、技术|テクニックについて話します。|使用「テクニック」的例句：谈论技巧、技术
デザート|dessert|甜食|食後にデザートを食べる|饭后吃甜点
デザイン|design|设计|デザインを持っています。|使用「デザイン」的例句：有设计
デフレ|deflation|通货紧缩|デフレはとても大切です。|使用「デフレ」的例句：通货紧缩很重要
デモ|demonstration|示威|旅行街でデモが行われている|街上正在进行示威游行
テロ|terror|恐怖行为|テロが好きです。|使用「テロ」的例句：喜欢恐怖行为
トランプ|trump|扑克牌|家族でトランプをする|和家人一起玩扑克牌
トレーニング|training|训练、练习|毎日ジムでトレーニングする|每天在健身房训练
トンネル|tunnel|隧道|このトンネルを抜けると、海が見えてくるよ|穿过这个隧道后，就能看到大海了
ナイーブ|naivety|天真烂漫|彼はナイーブな性格だ|他性格单纯
ナンセンス|nonsense|荒谬的；无意义的|そんな話、ナンセンスだよ|那种说法太荒唐了
ニュアンス|nuance|微妙的区别|微妙なニュアンスの違いがある|有细微的意义差别
バーゲン|bargain|大减价|バーゲン気持ちです。|使用「バーゲン」的例句：大减价的心情
ハード|hard|硬、困难|ハードについて話します。|使用「ハード」的例句：谈论硬、困难
ハーフ|half|一半；混血儿|中国人とフランス人のハーフ|中法混血儿
パターン|pattern|型、模式|生活のパターンを変えたい|想改变生活模式
バランス|balance|平衡、均衡|仕事と生活のバランスを取る|保持工作与生活的平衡
パンク|punk|爆胎|新しいパンクです。|使用「パンク」的例句：新的爆胎
ビタミン|vitamin|维生素|ビタミンについて話します。|使用「ビタミン」的例句：谈论维生素
ビニール|vinyl|塑料|これはビニールです。|使用「ビニール」的例句：这是塑料
ヒント|hint|暗示、提示|クイズのヒントをもらった|得到了谜题的提示
ファン|fan|粉丝、风扇|ファンを持っています。|使用「ファン」的例句：有粉丝、风扇
ブーム|boom|热潮、高潮|健康ブームが続いている|健康热潮持续中
ブザー|buzzer|蜂鸣器|試合終了のブザーが鳴る|比赛结束的蜂鸣器响了
プラス|plus|加号；有利|新しい経験は自分にとってプラスになる|新的经验对自己是有益的
プレッシャー|pressure|压力|新しいプレッシャーです。|使用「プレッシャー」的例句：新的压力
フレッシュ|fresh|新鲜、清新|フレッシュ気持ちです。|使用「フレッシュ」的例句：新鲜、清新的心情
プロ|professional|专业的、职业的|彼はプロのカメラマンだ|他是专业摄影师
プログラム|program|计划；电脑程序|会議のプログラムを確認する|确认会议的日程安排
フロント|front|正面；前台|ホテルのフロントでチェックインする|在酒店前台办理入住
ベンチ|bench|长椅、长凳|公園のベンチで休憩する|在公园的长椅上休息
ホイル|foil|锡纸|ホイルについて話します。|使用「ホイル」的例句：谈论锡纸
ポーズ|pose|姿势|カメラに向かってポーズをとる|朝着相机摆姿势
ポスター|poster|海报、宣传画|コンサートのポスター|音乐会的海报
ホチキス|Hotchkiss|订书机|新しいホチキスです。|使用「ホチキス」的例句：新的订书机
ポット|pot|茶壶；暖水瓶|お茶をポットで入れる|用茶壶泡茶
マイペース|my pace|自己的步调|マイペースところです。|使用「マイペース」的例句：自己的步调的地方
マスク|mask|口罩；面具|風邪をひいたのでマスクをする|感冒了，所以戴口罩
マスコミ|mass media|大众传媒|マスコミに報道された|被媒体报道了
ミス|miss|失误、错误|これはミスです。|使用「ミス」的例句：这是失误、错误
ムード|mood|气氛、心情|試験に合格したから、今日はお祝いムードだ|考试合格了，今天想好好庆祝一下
メッセージ|message|信息；致辞|友達にメッセージを送る|给朋友发送信息
ユーモア|humor|幽默|彼はユーモアのセンスがある|他很有幽默感
ユニーク|unique|唯一的、独特的|彼の考え方はユニークだ|他的想法很独特
ライター|lighter|打火机|ガスライターで火をつける|用打火机点火
ライバル|rival|竞争对手|ライバルを持っています。|使用「ライバル」的例句：有竞争对手
ラッシュ|rush|高峰时间|通勤ラッシュ|上下班高峰期
リーダー|leader|领导者|リーダーが好きです。|使用「リーダー」的例句：喜欢领导者
リズム|rhythm|韵律、节奏|音楽のリズムに乗って踊る|跟着音乐的节奏跳舞
リビング|living|客厅|リビングを持っています。|使用「リビング」的例句：有客厅
リラックス|relax|放松|これはリラックスです。|使用「リラックス」的例句：这是放松
ルーズ|loose|松懈、散漫|彼は時間にルーズだ|他对时间很随便
レジ|register|收银台|レジが好きです。|使用「レジ」的例句：喜欢收银台
レジャー|leisure|闲暇、业余时间|これはレジャーです。|使用「レジャー」的例句：这是闲暇、业余时间
レバー|lever|杆、操纵杆|レバーを引いてドアを開ける|拉动操纵杆打开门
レンタル|rental|租赁、出租|レンタルが好きです。|使用「レンタル」的例句：喜欢租赁、出租
ロビー|lobby|大厅、门厅|ホテルのロビーで待ち合わせる|在酒店大堂等人

【副词篇】
あいにく|不凑巧|あいにく留守にしていました|あいにく天気ですね。|使用「あいにく」的例句：あいにく留守にしていました的天气呢
あらゆる|所有|あらゆる手段を試す|あらゆるはとても大切です。|使用「あらゆる」的例句：あらゆる手段を試す很重要
いきなり|突然、冷不防|いきなり泣き出した|いきなり天気ですね。|使用「いきなり」的例句：いきなり泣き出した的天气呢
一層|いっそう|更加|一層努力する|更加努力
一応|いちおう|姑且、大体|一応説明しておく|姑且说明一下
一斉に|いっせいに|一齐、同时|一斉に立ち上がる|同时站起来
一旦|いったん|一旦；姑且、暂且|一旦決めたら最後までやる|一旦決定就要做到最后
いつのまにか|不知不觉地|いつのまにか夜になった|いつのまにか気持ちです。|使用「いつのまにか」的例句：いつのまにか夜になった的心情
いよいよ|到底、终于；越发、更加|いよいよ試合が始まる|比赛终于要开始了|年末が近づき、いよいよ忙しくなる
言わば|いわば|说起来|言わば彼はチームの柱だ|可以说他是团队的支柱
凡そ|およそ|大概、大约|およそ百人が参加した|大约有一百人参加
くれぐれも|一定、千万|くれぐれも気をつけてください|くれぐれもところです。|使用「くれぐれも」的例句：くれぐれも気をつけてください的地方
さっさと|赶快、迅速|さっさと片付ける|さっさとを買いました。|使用「さっさと」的例句：买了さっさと片付ける
更に|さらに|更、越发；再一次、又|更に勉強を頑張る|更加努力学习
直に|じかに|直接|じかに社長と話す|直接和社长交谈
しきりに|一个劲地、不停地|雪がしきりに降っている|しきりに人です。|使用「しきりに」的例句：雪がしきりに降っている的人
従って|したがって|所以、因而|私はその場にいなかった。したがって何も知らない|我当时不在场，所以什么也不知道
徐々に|じょじょに|逐渐、渐渐|徐徐にスピードを上げる|逐渐加速
ずらり|成排地、一大排|ずらりと並べられた商品|ずらりについて話します。|使用「ずらり」的例句：谈论ずらりと並べられた商品
折角|せっかく|特意、好不容易|折角のチャンスを逃した|错失了好不容易得到的机会
せっせと|拼命地、不停地|せっせと働く|せっせとが好きです。|使用「せっせと」的例句：喜欢せっせと働く
せめて|至少、最低|せめて一言言ってほしい|せめて人です。|使用「せめて」的例句：せめて一言言ってほしい的人
今にも|いまにも|马上就要|今にも雨が降りそうだ|马上就要下雨了
大いに|おおいに|非常|大いに盛り上がる|非常热闹
思い切り|おもいきり|尽量地、狠狠地|思い切り遊ぶ|尽情地玩耍
思わず|おもわず|不知不觉地|思わず笑ってしまった|不由自主地笑了出来
必ずしも|かならずしも|不一定、未必|必ずしも成功するとは限らない|不一定能成功
決して|けっして|决不、千万别|決して諦めない|绝不放弃
早速|さっそく|立刻、马上|早速準備を始める|立刻开始准备
始終|しじゅう|始終、不断|始終機嫌が悪い|始終心情不好
ちっとも|一点也不、毫不|ちっとも面白くない|とてもちっともです。|使用「ちっとも」的例句：非常ちっとも面白くない
徹底的に|てっていてきに|贯彻到底|徹底的に調査する|彻底调査
とっくに|很早、已经|とっくに知っている|とてもとっくにです。|使用「とっくに」的例句：非常とっくに知っている
どうせ|反正、终归|どうせやるなら全力で|どうせが好きです。|使用「どうせ」的例句：喜欢どうせやるなら全力で
一先ず|ひとまず|暂且、姑且|一先ず休憩しよう|暂且休息一下吧
独りでに|ひとりでに|自然而然、自动地|独りでにドアが開いた|门自动开了
滅多に|めったに|(不)常、很(少)|都会では蛍は滅多に見られなくなった。|在都市里已经很难见到萤火虫了。
僅かに|わずかに|仅、稍微、一点点|僅かに値段が上がった|价格稍微上涨了一点
少なくとも|すくなくとも|至少、起码|少なくとも三日かかる|至少需要三天
直ちに|ただちに|立刻、马上|直ちに対応する|立即应对
残らず|のこらず|全部|(例句缺失)|(例句缺失)
果たして|はたして|果然|果たして本当にそうだろうか|果然真的是这样吗？
ばったり|突然、意外遇见|友達にばったり出会う|ばったりを買いました。|使用「ばったり」的例句：买了友達にばったり出会う
必死に|ひっしに|拼命|必死に走る|拼命地跑
一通り|ひととおり|大概、大略|一通り目を通す|大致看了一遍
前もって|まえもって|事先、预先|前もって知らせる|事先通知
要するに|ようするに|总而言之|要するに彼は怠け者だ|总而言之，他是个懒人
割に|わりに|比较地；意外地|わりにやさしい問題|相对简单的问题
俄か|にわか|突然、马上|にわかに空が暗くなった|天空突然变暗了

